ACCGGAACGGAAATCTTTTAGGGG -> CCGGAACGGAAATCTTTTAGGGGG
GGCCGCGAACACTATTCTTTAAGG -> GCCGCGAACACTATTCTTTAAGGC
TTCATCTCTGCCTAATGACCTTAT -> TCATCTCTGCCTAATGACCTTATC
GGAACGGAAATCTTTTAGGGGGAC -> GAACGGAAATCTTTTAGGGGGACA
CTCTCGCATGGGGACGATCCAGAT -> TCTCGCATGGGGACGATCCAGATT
ATGATCAAATAAGTTAGTTCCTGA -> TGATCAAATAAGTTAGTTCCTGAG
CTTTGCCTATAATAACTGCGGTGT -> TTTGCCTATAATAACTGCGGTGTG
AGGCCGAAGGGCCGCGAACACTAT -> GGCCGAAGGGCCGCGAACACTATT
GAAGTGACTGACACGGTGCTGTGT -> AAGTGACTGACACGGTGCTGTGTT
AAAACTCGGAGCTCTCGCATGGGG -> AAACTCGGAGCTCTCGCATGGGGA
GTAGCTAGTGTCGCGTAGCGTGAC -> TAGCTAGTGTCGCGTAGCGTGACT
CTTTAGATACACGTCTCGAACATG -> TTTAGATACACGTCTCGAACATGG
TGACGTCGCGATTAATGGATCGTT -> GACGTCGCGATTAATGGATCGTTT
CTCCGACCGGAACGGAAATCTTTT -> TCCGACCGGAACGGAAATCTTTTA
TGAGCGACCTCAACCTGTTACTCC -> GAGCGACCTCAACCTGTTACTCCC
GGAGACACGTAATCACGCATAGGC -> GAGACACGTAATCACGCATAGGCC
GCGAACGCCTCGCGCACCAGTACT -> CGAACGCCTCGCGCACCAGTACTT
TTTGCCAGACAAGTAACCTAGTAG -> TTGCCAGACAAGTAACCTAGTAGG
TTTTACATTCGATGGACGCTGCTC -> TTTACATTCGATGGACGCTGCTCT
ACTGCGGTGTGCTCGCGAACGCCT -> CTGCGGTGTGCTCGCGAACGCCTC
CCCGAAATCGAGCGCTGGAGACAT -> CCGAAATCGAGCGCTGGAGACATC
GCCTTGACTTTGCCTATAATAACT -> CCTTGACTTTGCCTATAATAACTG
ACATTCGATGGACGCTGCTCTTGC -> CATTCGATGGACGCTGCTCTTGCC
GAATGCTTCATCTACCTACAAAAA -> AATGCTTCATCTACCTACAAAAAT
TCACTGGGGAGATGTACCTTGACA -> CACTGGGGAGATGTACCTTGACAC
GTGACGTCGCGATTAATGGATCGT -> TGACGTCGCGATTAATGGATCGTT
ACGGGCACTAGCCCATCCGGTCCC -> CGGGCACTAGCCCATCCGGTCCCC
TCCATCCAATAAAACTCGGAGCTC -> CCATCCAATAAAACTCGGAGCTCT
TCAGCAAGTCGGAGGTGTGGCAAG -> CAGCAAGTCGGAGGTGTGGCAAGG
TGTGGCAAGGTTTCACTAGTCAAT -> GTGGCAAGGTTTCACTAGTCAATT
TCACTATGCCTTGACTTTGCCTAT -> CACTATGCCTTGACTTTGCCTATA
AGGAGAACAAGTTGACCCTTCCTG -> GGAGAACAAGTTGACCCTTCCTGC
CCTACAAAAATACCAGTCAACCAG -> CTACAAAAATACCAGTCAACCAGA
TAATGGATCGTTTCCTTTAAACAG -> AATGGATCGTTTCCTTTAAACAGT
AAGTGACTGACACGGTGCTGTGTT -> AGTGACTGACACGGTGCTGTGTTG
GACCATCGCAGGAGAACAAGTTGA -> ACCATCGCAGGAGAACAAGTTGAC
CCGAAATCGAGCGCTGGAGACATC -> CGAAATCGAGCGCTGGAGACATCA
GCCGTTTTCAACTTGTCAGCAAGT -> CCGTTTTCAACTTGTCAGCAAGTC
ATTTTTGAGACCGAAACCCCTGAT -> TTTTTGAGACCGAAACCCCTGATC
TTAACACACGGAGGCCGAAAGCAT -> TAACACACGGAGGCCGAAAGCATT
CAATCTAACCCGTCCGTCTCTTTC -> AATCTAACCCGTCCGTCTCTTTCT
GTGTGGCAAGGTTTCACTAGTCAA -> TGTGGCAAGGTTTCACTAGTCAAT
GGGACGATCCAGATTACGAAGTTA -> GGACGATCCAGATTACGAAGTTAT
GAACATGGTCCCTTCATCTCTGCC -> AACATGGTCCCTTCATCTCTGCCT
TTAAGAGGGACCTGCCAACTTCTA -> TAAGAGGGACCTGCCAACTTCTAC
CAGAGGGGTTCTTCTGTCCGCGAC -> AGAGGGGTTCTTCTGTCCGCGACA
CCATCTCGCGTACGATATCAATCA -> CATCTCGCGTACGATATCAATCAC
ACCAGCGCATCATTTGGCCCTCTT -> CCAGCGCATCATTTGGCCCTCTTA
TCGTCTCCGAAAGATTCGTCCGAC -> CGTCTCCGAAAGATTCGTCCGACT
GCCTATATTGTCGTCGCAACGATT -> CCTATATTGTCGTCGCAACGATTC
CGGAGCTCTCGCATGGGGACGATC -> GGAGCTCTCGCATGGGGACGATCC
AGCTAGTGTCGCGTAGCGTGACTA -> GCTAGTGTCGCGTAGCGTGACTAC
TACACGTCTCGAACATGGTCCCTT -> ACACGTCTCGAACATGGTCCCTTC
CTCCTGCAAGGCCTGGTGTCCCCC -> TCCTGCAAGGCCTGGTGTCCCCCG
TTGTCAGCAAGTCGGAGGTGTGGC -> TGTCAGCAAGTCGGAGGTGTGGCA
AAGTTATCCGCGGGGCAATCCTCT -> AGTTATCCGCGGGGCAATCCTCTG
TGTCCCCCGATAAGACACGGTAAC -> GTCCCCCGATAAGACACGGTAACC
GGGAGATGTACCTTGACACCGCAA -> GGAGATGTACCTTGACACCGCAAC
CGCCCTGCTTTCCGATTGGATTGG -> GCCCTGCTTTCCGATTGGATTGGG
GCGTACGATATCAATCACTGCATG -> CGTACGATATCAATCACTGCATGT
TCGTCCGACTATAGGAATCCGTGC -> CGTCCGACTATAGGAATCCGTGCT
GGCACTAGCCCATCCGGTCCCCAC -> GCACTAGCCCATCCGGTCCCCACA
CCCTCTTATTAAGAGGGACCTGCC -> CCTCTTATTAAGAGGGACCTGCCA
GAACGGAAATCTTTTAGGGGGACA -> AACGGAAATCTTTTAGGGGGACAA
CCTATAATAACTGCGGTGTGCTCG -> CTATAATAACTGCGGTGTGCTCGC
TGTATGCCATCATCTATGTGATAC -> GTATGCCATCATCTATGTGATACA
GAAAGCATTATCAGTCTTTGGCAG -> AAAGCATTATCAGTCTTTGGCAGC
GCCCGTCCCTCGTAGTCCCCCAGC -> CCCGTCCCTCGTAGTCCCCCAGCA
TTATTAAGAGGGACCTGCCAACTT -> TATTAAGAGGGACCTGCCAACTTC
TCCGTGCTGGAGGGGCAAGCCCCC -> CCGTGCTGGAGGGGCAAGCCCCCG
CGACCATCTCGCGTACGATATCAA -> GACCATCTCGCGTACGATATCAAT
TGTGTTGTTGTTGGTCATAGTATT -> GTGTTGTTGTTGGTCATAGTATTT
AGTTTTACATTCGATGGACGCTGC -> GTTTTACATTCGATGGACGCTGCT
CGACATGGGAGGCCCGTCCCTCGT -> GACATGGGAGGCCCGTCCCTCGTA
TATTAAGAGGGACCTGCCAACTTC -> ATTAAGAGGGACCTGCCAACTTCT
TATTTTTGAGACCGAAACCCCTGA -> ATTTTTGAGACCGAAACCCCTGAT
CGTCCGTCTCTTTCTTGGCACCAC -> GTCCGTCTCTTTCTTGGCACCACC
AGGGCCGCGAACACTATTCTTTAA -> GGGCCGCGAACACTATTCTTTAAG
ACCAGATTCGCCTGGGCTGGTCAA -> CCAGATTCGCCTGGGCTGGTCAAA
TATGCCATCATCTATGTGATACAA -> ATGCCATCATCTATGTGATACAAT
TCGCAGAGGGGTTCTTCTGTCCGC -> CGCAGAGGGGTTCTTCTGTCCGCG
AGGTTTCACTAGTCAATTTGCACT -> GGTTTCACTAGTCAATTTGCACTA
GACATGGGAGGCCCGTCCCTCGTA -> ACATGGGAGGCCCGTCCCTCGTAG
GTCAACCAGATTCGCCTGGGCTGG -> TCAACCAGATTCGCCTGGGCTGGT
CAGATCCCATTTGGAATCCATCCA -> AGATCCCATTTGGAATCCATCCAA
AAACAGTGCTATGGGGAATGCTCA -> AACAGTGCTATGGGGAATGCTCAA
GTTGTCCACTACCTTAGTGGCTCC -> TTGTCCACTACCTTAGTGGCTCCG
GACACCGCAACTTTCTCACCGGAG -> ACACCGCAACTTTCTCACCGGAGA
CTTCTACGATCTGGACCATCGCAG -> TTCTACGATCTGGACCATCGCAGG
TCTTCTGTCCGCGACATGGGAGGC -> CTTCTGTCCGCGACATGGGAGGCC
AACCTAGTAGGGCCGGTGCTTAAC -> ACCTAGTAGGGCCGGTGCTTAACA
TCATCTATGTGATACAATCTAACC -> CATCTATGTGATACAATCTAACCC
GCCATCATCTATGTGATACAATCT -> CCATCATCTATGTGATACAATCTA
GCTCCAGGTCACCCTCCCCCCCGG -> CTCCAGGTCACCCTCCCCCCCGGA
CCTGCCAACTTCTACGATCTGGAC -> CTGCCAACTTCTACGATCTGGACC
CAGAAGTGACTGACACGGTGCTGT -> AGAAGTGACTGACACGGTGCTGTG
CACTAGTCAATTTGCACTACGCCC -> ACTAGTCAATTTGCACTACGCCCT
GGGAATGCTCAACACTCCTGCAAG -> GGAATGCTCAACACTCCTGCAAGG
GATGGACGCTGCTCTTGCCAGGCC -> ATGGACGCTGCTCTTGCCAGGCCC
CAATACGGCTGAGGTTCTCTTTTC -> AATACGGCTGAGGTTCTCTTTTCG
TAGTATTTTTGAGACCGAAACCCC -> AGTATTTTTGAGACCGAAACCCCT
AATATAGATAGAGAACACCGGGAA -> ATATAGATAGAGAACACCGGGAAT
CCCCGGATCACTAGGGGCTGGATT -> CCCGGATCACTAGGGGCTGGATTC
CGTCGCGATTAATGGATCGTTTCC -> GTCGCGATTAATGGATCGTTTCCT
ATGCTTCATCTACCTACAAAAATA -> TGCTTCATCTACCTACAAAAATAC
CCTGATACCAGCGCATCATTTGGC -> CTGATACCAGCGCATCATTTGGCC
ACCGAAACCCCTGATCTCAAAAAG -> CCGAAACCCCTGATCTCAAAAAGA
GATAAACGGGCACTAGCCCATCCG -> ATAAACGGGCACTAGCCCATCCGG
AATGGATCGTTTCCTTTAAACAGT -> ATGGATCGTTTCCTTTAAACAGTG
CCAGTCAACCAGATTCGCCTGGGC -> CAGTCAACCAGATTCGCCTGGGCT
TGTATCCATCGCAGAGGGGTTCTT -> GTATCCATCGCAGAGGGGTTCTTC
AACCTGTTACTCCCATCAATATAT -> ACCTGTTACTCCCATCAATATATG
TTGACTTTGCCTATAATAACTGCG -> TGACTTTGCCTATAATAACTGCGG
TGCTTAACACACGGAGGCCGAAAG -> GCTTAACACACGGAGGCCGAAAGC
CTGCACCCTAGGTTCAAGGATAAC -> TGCACCCTAGGTTCAAGGATAACA
GTCTCCGAAAGATTCGTCCGACTA -> TCTCCGAAAGATTCGTCCGACTAT
ACATGGGAGGCCCGTCCCTCGTAG -> CATGGGAGGCCCGTCCCTCGTAGT
CCGAAACCCCTGATCTCAAAAAGA -> CGAAACCCCTGATCTCAAAAAGAA
AGGCCGAAAGCATTATCAGTCTTT -> GGCCGAAAGCATTATCAGTCTTTG
AGGGCCGGTGCTTAACACACGGAG -> GGGCCGGTGCTTAACACACGGAGG
TCCCCCAGCAGCACCTGCCTATAT -> CCCCCAGCAGCACCTGCCTATATT
TTTTCGTCTCCGAAAGATTCGTCC -> TTTCGTCTCCGAAAGATTCGTCCG
ATCCGTGCTGGAGGGGCAAGCCCC -> TCCGTGCTGGAGGGGCAAGCCCCC
TATAGATAGAGAACACCGGGAATG -> ATAGATAGAGAACACCGGGAATGA
TACGGCTGAGGTTCTCTTTTCGTC -> ACGGCTGAGGTTCTCTTTTCGTCT
TGGCCCTCTTATTAAGAGGGACCT -> GGCCCTCTTATTAAGAGGGACCTG
GTAGTCCCCCAGCAGCACCTGCCT -> TAGTCCCCCAGCAGCACCTGCCTA
TAATCGACGAAGGCTTTAGATACA -> AATCGACGAAGGCTTTAGATACAC
TTCGTCCGACTATAGGAATCCGTG -> TCGTCCGACTATAGGAATCCGTGC
TAGGGGGACAACAAAAAGTGCGGT -> AGGGGGACAACAAAAAGTGCGGTC
TTTGCACTACGCCCTGCTTTCCGA -> TTGCACTACGCCCTGCTTTCCGAT
ATTTGGCCCTCTTATTAAGAGGGA -> TTTGGCCCTCTTATTAAGAGGGAC
AATAACTGCGGTGTGCTCGCGAAC -> ATAACTGCGGTGTGCTCGCGAACG
CTTCATCTACCTACAAAAATACCA -> TTCATCTACCTACAAAAATACCAG
GATAAGACACGGTAACCATATATG -> ATAAGACACGGTAACCATATATGT
ATCGTGGTGTATGCCATCATCTAT -> TCGTGGTGTATGCCATCATCTATG
AATAAAACTCGGAGCTCTCGCATG -> ATAAAACTCGGAGCTCTCGCATGG
CCAATAAAACTCGGAGCTCTCGCA -> CAATAAAACTCGGAGCTCTCGCAT
TCGGAGCTCTCGCATGGGGACGAT -> CGGAGCTCTCGCATGGGGACGATC
GCATGCTCTCGTAAGTTTTACATT -> CATGCTCTCGTAAGTTTTACATTC
GCCGCGAACACTATTCTTTAAGGC -> CCGCGAACACTATTCTTTAAGGCA
GTGCTTAACACACGGAGGCCGAAA -> TGCTTAACACACGGAGGCCGAAAG
CGACGAAGGCTTTAGATACACGTC -> GACGAAGGCTTTAGATACACGTCT
CTCGAACATGGTCCCTTCATCTCT -> TCGAACATGGTCCCTTCATCTCTG
GCTGTGTTGTTGTTGGTCATAGTA -> CTGTGTTGTTGTTGGTCATAGTAT
CCGCGAACACTATTCTTTAAGGCA -> CGCGAACACTATTCTTTAAGGCAT
TTCTGCGTCACCGCAATACGGCTG -> TCTGCGTCACCGCAATACGGCTGA
TTTTAGGGGGACAACAAAAAGTGC -> TTTAGGGGGACAACAAAAAGTGCG
CGACCTCAACCTGTTACTCCCATC -> GACCTCAACCTGTTACTCCCATCA
AACCCCTGATCTCAAAAAGAACAT -> ACCCCTGATCTCAAAAAGAACATC
TCGCGATTAATGGATCGTTTCCTT -> CGCGATTAATGGATCGTTTCCTTT
GACCGGAACGGAAATCTTTTAGGG -> ACCGGAACGGAAATCTTTTAGGGG
CCGGAGACACGTAATCACGCATAG -> CGGAGACACGTAATCACGCATAGG
AGGGTGACGTCGCGATTAATGGAT -> GGGTGACGTCGCGATTAATGGATC
GTGCTGGAGGGGCAAGCCCCCGTA -> TGCTGGAGGGGCAAGCCCCCGTAA
CTCTGACAATATAGATAGAGAACA -> TCTGACAATATAGATAGAGAACAC
CCACTACCTTAGTGGCTCCGACCG -> CACTACCTTAGTGGCTCCGACCGG
TGCGGTCGCCGTTTTCAACTTGTC -> GCGGTCGCCGTTTTCAACTTGTCA
TATGTGATACAATCTAACCCGTCC -> ATGTGATACAATCTAACCCGTCCG
TGTCCACTACCTTAGTGGCTCCGA -> GTCCACTACCTTAGTGGCTCCGAC
TGACTGACACGGTGCTGTGTTGTT -> GACTGACACGGTGCTGTGTTGTTG
CACCACCACCCATCGTGATAGTCA -> ACCACCACCCATCGTGATAGTCAC
GCTTTAGATACACGTCTCGAACAT -> CTTTAGATACACGTCTCGAACATG
TGTCAGCAAGTCGGAGGTGTGGCA -> GTCAGCAAGTCGGAGGTGTGGCAA
TCCTGAGCGACCTCAACCTGTTAC -> CCTGAGCGACCTCAACCTGTTACT
TTTTTCTCGTAGTTCTGCGTCACC -> TTTTCTCGTAGTTCTGCGTCACCG
TGTGATACAATCTAACCCGTCCGT -> GTGATACAATCTAACCCGTCCGTC
GCCGAAAGCATTATCAGTCTTTGG -> CCGAAAGCATTATCAGTCTTTGGC
CTTTAAGGCATGCTCTCGTAAGTT -> TTTAAGGCATGCTCTCGTAAGTTT
AGCCTCTTTAGCTGCATATAATCG -> GCCTCTTTAGCTGCATATAATCGA
GGTTGTCCACTACCTTAGTGGCTC -> GTTGTCCACTACCTTAGTGGCTCC
TCCGACCATCTCGCGTACGATATC -> CCGACCATCTCGCGTACGATATCA
ACAAAAATACCAGTCAACCAGATT -> CAAAAATACCAGTCAACCAGATTC
ACCTGTTACTCCCATCAATATATG -> CCTGTTACTCCCATCAATATATGG
TGATCAAATAAGTTAGTTCCTGAG -> GATCAAATAAGTTAGTTCCTGAGC
AGCCCATCCGGTCCCCACATCGTG -> GCCCATCCGGTCCCCACATCGTGG
GGACGATCCAGATTACGAAGTTAT -> GACGATCCAGATTACGAAGTTATC
CTATTCTTTAAGGCATGCTCTCGT -> TATTCTTTAAGGCATGCTCTCGTA
AACGGAAATCTTTTAGGGGGACAA -> ACGGAAATCTTTTAGGGGGACAAC
TTAAACAGTGCTATGGGGAATGCT -> TAAACAGTGCTATGGGGAATGCTC
CGAAACCCCTGATCTCAAAAAGAA -> GAAACCCCTGATCTCAAAAAGAAC
TGGATAAACGGGCACTAGCCCATC -> GGATAAACGGGCACTAGCCCATCC
GTTTCCTTTAAACAGTGCTATGGG -> TTTCCTTTAAACAGTGCTATGGGG
GGGACAACAAAAAGTGCGGTCGCC -> GGACAACAAAAAGTGCGGTCGCCG
CATTTGGCCCTCTTATTAAGAGGG -> ATTTGGCCCTCTTATTAAGAGGGA
TCACTGCATGTATCCATCGCAGAG -> CACTGCATGTATCCATCGCAGAGG
TGGAGGGGCAAGCCCCCGTAAGGA -> GGAGGGGCAAGCCCCCGTAAGGAC
GATCACTATGCCTTGACTTTGCCT -> ATCACTATGCCTTGACTTTGCCTA
TCCTGCAAGGCCTGGTGTCCCCCG -> CCTGCAAGGCCTGGTGTCCCCCGA
CCTAGTAGGGCCGGTGCTTAACAC -> CTAGTAGGGCCGGTGCTTAACACA
AAAAAAATACGAGGTATTTTTTCT -> AAAAAATACGAGGTATTTTTTCTC
AATGGGTTCGGGCTCCAGGTCACC -> ATGGGTTCGGGCTCCAGGTCACCC
CTGACACGGTGCTGTGTTGTTGTT -> TGACACGGTGCTGTGTTGTTGTTG
TAGGGGCTGGATTCCGACCATCTC -> AGGGGCTGGATTCCGACCATCTCG
GCCAGGCCCAATGGGTTCGGGCTC -> CCAGGCCCAATGGGTTCGGGCTCC
TTGTTGGTCATAGTATTTTTGAGA -> TGTTGGTCATAGTATTTTTGAGAC
ACCTAGTAGGGCCGGTGCTTAACA -> CCTAGTAGGGCCGGTGCTTAACAC
ACCTCAACCTGTTACTCCCATCAA -> CCTCAACCTGTTACTCCCATCAAT
TCTTGGCACCACCACCCATCGTGA -> CTTGGCACCACCACCCATCGTGAT
ACTGACACGGTGCTGTGTTGTTGT -> CTGACACGGTGCTGTGTTGTTGTT
CCATCAATATATGGGTTGTCCACT -> CATCAATATATGGGTTGTCCACTA
GGAATGATCAAATAAGTTAGTTCC -> GAATGATCAAATAAGTTAGTTCCT
ACGGTGCTGTGTTGTTGTTGGTCA -> CGGTGCTGTGTTGTTGTTGGTCAT
GGCTGGTCAAAAGATCACTATGCC -> GCTGGTCAAAAGATCACTATGCCT
TATAATAACTGCGGTGTGCTCGCG -> ATAATAACTGCGGTGTGCTCGCGA
GGGCTGGTCAAAAGATCACTATGC -> GGCTGGTCAAAAGATCACTATGCC
GTACCTTGACACCGCAACTTTCTC -> TACCTTGACACCGCAACTTTCTCA
GACACGGTAACCATATATGTAGCT -> ACACGGTAACCATATATGTAGCTA
CTCGGAGCTCTCGCATGGGGACGA -> TCGGAGCTCTCGCATGGGGACGAT
GAGAACAAGTTGACCCTTCCTGCT -> AGAACAAGTTGACCCTTCCTGCTG
GTGTCGCGTAGCGTGACTACTCGA -> TGTCGCGTAGCGTGACTACTCGAT
TAGTCACTGGGGAGATGTACCTTG -> AGTCACTGGGGAGATGTACCTTGA
CCATTTGGAATCCATCCAATAAAA -> CATTTGGAATCCATCCAATAAAAC
AAATACCAGTCAACCAGATTCGCC -> AATACCAGTCAACCAGATTCGCCT
CCAACTTCTACGATCTGGACCATC -> CAACTTCTACGATCTGGACCATCG
ACGCTGCTCTTGCCAGGCCCAATG -> CGCTGCTCTTGCCAGGCCCAATGG
GATTCCGACCATCTCGCGTACGAT -> ATTCCGACCATCTCGCGTACGATA
ATGGGTTCGGGCTCCAGGTCACCC -> TGGGTTCGGGCTCCAGGTCACCCT
CGCAACTTTCTCACCGGAGACACG -> GCAACTTTCTCACCGGAGACACGT
CGTTTTCAACTTGTCAGCAAGTCG -> GTTTTCAACTTGTCAGCAAGTCGG
ATGCTCAACACTCCTGCAAGGCCT -> TGCTCAACACTCCTGCAAGGCCTG
GGCTCCAGGTCACCCTCCCCCCCG -> GCTCCAGGTCACCCTCCCCCCCGG
TCCTCTGACAATATAGATAGAGAA -> CCTCTGACAATATAGATAGAGAAC
CAGGTCACCCTCCCCCCCGGATCA -> AGGTCACCCTCCCCCCCGGATCAC
GGTAACCATATATGTAGCTAGTGT -> GTAACCATATATGTAGCTAGTGTC
TCGCATGGGGACGATCCAGATTAC -> CGCATGGGGACGATCCAGATTACG
GCATCATTTGGCCCTCTTATTAAG -> CATCATTTGGCCCTCTTATTAAGA
ATATGGGTTGTCCACTACCTTAGT -> TATGGGTTGTCCACTACCTTAGTG
TCCAGGTCACCCTCCCCCCCGGAT -> CCAGGTCACCCTCCCCCCCGGATC
TCACTAGGGGCTGGATTCCGACCA -> CACTAGGGGCTGGATTCCGACCAT
AAAAGATCACTATGCCTTGACTTT -> AAAGATCACTATGCCTTGACTTTG
GTCACCCTCCCCCCCGGATCACTA -> TCACCCTCCCCCCCGGATCACTAG
GGTGTATGCCATCATCTATGTGAT -> GTGTATGCCATCATCTATGTGATA
TGCTATGGGGAATGCTCAACACTC -> GCTATGGGGAATGCTCAACACTCC
TGGGGAATGCTCAACACTCCTGCA -> GGGGAATGCTCAACACTCCTGCAA
TTCCTGAGCGACCTCAACCTGTTA -> TCCTGAGCGACCTCAACCTGTTAC
CTCGTAAGTTTTACATTCGATGGA -> TCGTAAGTTTTACATTCGATGGAC
TAAACGGGCACTAGCCCATCCGGT -> AAACGGGCACTAGCCCATCCGGTC
CTGGAGACATCAACTGGACAGAAG -> TGGAGACATCAACTGGACAGAAGT
TACCTTAGTGGCTCCGACCGGAAC -> ACCTTAGTGGCTCCGACCGGAACG
CTCCAGGTCACCCTCCCCCCCGGA -> TCCAGGTCACCCTCCCCCCCGGAT
CATATATGTAGCTAGTGTCGCGTA -> ATATATGTAGCTAGTGTCGCGTAG
TCTTTCTTGGCACCACCACCCATC -> CTTTCTTGGCACCACCACCCATCG
ACATGGTCCCTTCATCTCTGCCTA -> CATGGTCCCTTCATCTCTGCCTAA
CATGGGAGGCCCGTCCCTCGTAGT -> ATGGGAGGCCCGTCCCTCGTAGTC
GATCAGATCCCATTTGGAATCCAT -> ATCAGATCCCATTTGGAATCCATC
TAATGACCTTATCTATTCCAGCTT -> AATGACCTTATCTATTCCAGCTTT
CAGTACTTGGTTTGATACAGTCTA -> AGTACTTGGTTTGATACAGTCTAG
ATCAAATAAGTTAGTTCCTGAGCG -> TCAAATAAGTTAGTTCCTGAGCGA
CCGTCTCTTTCTTGGCACCACCAC -> CGTCTCTTTCTTGGCACCACCACC
TCTTTTAGGGGGACAACAAAAAGT -> CTTTTAGGGGGACAACAAAAAGTG
CAATAAAACTCGGAGCTCTCGCAT -> AATAAAACTCGGAGCTCTCGCATG
CTGCATGTATCCATCGCAGAGGGG -> TGCATGTATCCATCGCAGAGGGGT
CTCACCGGAGACACGTAATCACGC -> TCACCGGAGACACGTAATCACGCA
TCTCAAAAAGAACATCTTTGCCAG -> CTCAAAAAGAACATCTTTGCCAGA
ATGCCTTGACTTTGCCTATAATAA -> TGCCTTGACTTTGCCTATAATAAC
ACCTTGACACCGCAACTTTCTCAC -> CCTTGACACCGCAACTTTCTCACC
TAGGTTCAAGGATAACAGAGCGCC -> AGGTTCAAGGATAACAGAGCGCCT
TTGCCAGGCCCAATGGGTTCGGGC -> TGCCAGGCCCAATGGGTTCGGGCT
ATAGAGAACACCGGGAATGATCAA -> TAGAGAACACCGGGAATGATCAAA
AAGTTGACCCTTCCTGCTGCACCC -> AGTTGACCCTTCCTGCTGCACCCT
CACTATTCTTTAAGGCATGCTCTC -> ACTATTCTTTAAGGCATGCTCTCG
CCTCGTAGTCCCCCAGCAGCACCT -> CTCGTAGTCCCCCAGCAGCACCTG
TGCACTACGCCCTGCTTTCCGATT -> GCACTACGCCCTGCTTTCCGATTG
AACCCGTCCGTCTCTTTCTTGGCA -> ACCCGTCCGTCTCTTTCTTGGCAC
CTCAACACTCCTGCAAGGCCTGGT -> TCAACACTCCTGCAAGGCCTGGTG
TCGCAGGAGAACAAGTTGACCCTT -> CGCAGGAGAACAAGTTGACCCTTC
TGGCACCACCACCCATCGTGATAG -> GGCACCACCACCCATCGTGATAGT
TAAGGCATGCTCTCGTAAGTTTTA -> AAGGCATGCTCTCGTAAGTTTTAC
CTTTCCGATTGGATTGGGAACCGC -> TTTCCGATTGGATTGGGAACCGCA
GTTACTCCCATCAATATATGGGTT -> TTACTCCCATCAATATATGGGTTG
AGGCCTGGTGTCCCCCGATAAGAC -> GGCCTGGTGTCCCCCGATAAGACA
CCCCCCCGGATCACTAGGGGCTGG -> CCCCCCGGATCACTAGGGGCTGGA
CATCCAATAAAACTCGGAGCTCTC -> ATCCAATAAAACTCGGAGCTCTCG
TGGTGTATGCCATCATCTATGTGA -> GGTGTATGCCATCATCTATGTGAT
GCTTTCCGATTGGATTGGGAACCG -> CTTTCCGATTGGATTGGGAACCGC
GACAGAAGTGACTGACACGGTGCT -> ACAGAAGTGACTGACACGGTGCTG
AGCACCTGCCTATATTGTCGTCGC -> GCACCTGCCTATATTGTCGTCGCA
GGAGGCCCGTCCCTCGTAGTCCCC -> GAGGCCCGTCCCTCGTAGTCCCCC
GGCCCTCTTATTAAGAGGGACCTG -> GCCCTCTTATTAAGAGGGACCTGC
GACTGACACGGTGCTGTGTTGTTG -> ACTGACACGGTGCTGTGTTGTTGT
GGAGATGTACCTTGACACCGCAAC -> GAGATGTACCTTGACACCGCAACT
AGTCAATTTGCACTACGCCCTGCT -> GTCAATTTGCACTACGCCCTGCTT
GTGTCCCCCGATAAGACACGGTAA -> TGTCCCCCGATAAGACACGGTAAC
TCGCGTAGCGTGACTACTCGATAC -> CGCGTAGCGTGACTACTCGATACC
CGAAAGATTCGTCCGACTATAGGA -> GAAAGATTCGTCCGACTATAGGAA
TCGATGGACGCTGCTCTTGCCAGG -> CGATGGACGCTGCTCTTGCCAGGC
TGCCTAATGACCTTATCTATTCCA -> GCCTAATGACCTTATCTATTCCAG
CGCAACGATTCGATCAGATCCCAT -> GCAACGATTCGATCAGATCCCATT
CGTCTCGAACATGGTCCCTTCATC -> GTCTCGAACATGGTCCCTTCATCT
CTTTTCGTCTCCGAAAGATTCGTC -> TTTTCGTCTCCGAAAGATTCGTCC
GAGCGCTGGAGACATCAACTGGAC -> AGCGCTGGAGACATCAACTGGACA
CTGCCTATATTGTCGTCGCAACGA -> TGCCTATATTGTCGTCGCAACGAT
GACATCAACTGGACAGAAGTGACT -> ACATCAACTGGACAGAAGTGACTG
ATTCCGACCATCTCGCGTACGATA -> TTCCGACCATCTCGCGTACGATAT
TGCTCGCGAACGCCTCGCGCACCA -> GCTCGCGAACGCCTCGCGCACCAG
CGGGCACTAGCCCATCCGGTCCCC -> GGGCACTAGCCCATCCGGTCCCCA
TTACTCCCATCAATATATGGGTTG -> TACTCCCATCAATATATGGGTTGT
GGGTGACGTCGCGATTAATGGATC -> GGTGACGTCGCGATTAATGGATCG
TCGATACCCCTGATACCAGCGCAT -> CGATACCCCTGATACCAGCGCATC
GCACCTGCCTATATTGTCGTCGCA -> CACCTGCCTATATTGTCGTCGCAA
CATCGTGATAGTCACTGGGGAGAT -> ATCGTGATAGTCACTGGGGAGATG
TTTTTTCTCGTAGTTCTGCGTCAC -> TTTTTCTCGTAGTTCTGCGTCACC
TGATAGTCACTGGGGAGATGTACC -> GATAGTCACTGGGGAGATGTACCT
TTCCTGCTGCACCCTAGGTTCAAG -> TCCTGCTGCACCCTAGGTTCAAGG
ATCACTAGGGGCTGGATTCCGACC -> TCACTAGGGGCTGGATTCCGACCA
ACCTGCCTATATTGTCGTCGCAAC -> CCTGCCTATATTGTCGTCGCAACG
CATCTCTGCCTAATGACCTTATCT -> ATCTCTGCCTAATGACCTTATCTA
TCGTTTCCTTTAAACAGTGCTATG -> CGTTTCCTTTAAACAGTGCTATGG
TAGGGCCGGTGCTTAACACACGGA -> AGGGCCGGTGCTTAACACACGGAG
TGGACAGAAGTGACTGACACGGTG -> GGACAGAAGTGACTGACACGGTGC
GCCTCGCGCACCAGTACTTGGTTT -> CCTCGCGCACCAGTACTTGGTTTG
TGTGCTCGCGAACGCCTCGCGCAC -> GTGCTCGCGAACGCCTCGCGCACC
ATCTAACCCGTCCGTCTCTTTCTT -> TCTAACCCGTCCGTCTCTTTCTTG
ACCTTAGTGGCTCCGACCGGAACG -> CCTTAGTGGCTCCGACCGGAACGG
CTGTTACTCCCATCAATATATGGG -> TGTTACTCCCATCAATATATGGGT
CGCCTAAAAAAATACGAGGTATTT -> GCCTAAAAAAATACGAGGTATTTT
GATTCGATCAGATCCCATTTGGAA -> ATTCGATCAGATCCCATTTGGAAT
TCGTGGTGTATGCCATCATCTATG -> CGTGGTGTATGCCATCATCTATGT
AGATTCGTCCGACTATAGGAATCC -> GATTCGTCCGACTATAGGAATCCG
CTCAACCTGTTACTCCCATCAATA -> TCAACCTGTTACTCCCATCAATAT
CCGCGGGGCAATCCTCTGACAATA -> CGCGGGGCAATCCTCTGACAATAT
GCCTCTTTAGCTGCATATAATCGA -> CCTCTTTAGCTGCATATAATCGAC
GGTTCGGGCTCCAGGTCACCCTCC -> GTTCGGGCTCCAGGTCACCCTCCC
ATCATCTATGTGATACAATCTAAC -> TCATCTATGTGATACAATCTAACC
GTAACCTAGTAGGGCCGGTGCTTA -> TAACCTAGTAGGGCCGGTGCTTAA
CTAGTCAATTTGCACTACGCCCTG -> TAGTCAATTTGCACTACGCCCTGC
TAGTGTCGCGTAGCGTGACTACTC -> AGTGTCGCGTAGCGTGACTACTCG
TGTTACTCCCATCAATATATGGGT -> GTTACTCCCATCAATATATGGGTT
AAGGTTTCACTAGTCAATTTGCAC -> AGGTTTCACTAGTCAATTTGCACT
GTACGATATCAATCACTGCATGTA -> TACGATATCAATCACTGCATGTAT
CAACTTCTACGATCTGGACCATCG -> AACTTCTACGATCTGGACCATCGC
GTTGGTCATAGTATTTTTGAGACC -> TTGGTCATAGTATTTTTGAGACCG
AATCGACGAAGGCTTTAGATACAC -> ATCGACGAAGGCTTTAGATACACG
CGCATGGGGACGATCCAGATTACG -> GCATGGGGACGATCCAGATTACGA
ATCGCAGAGGGGTTCTTCTGTCCG -> TCGCAGAGGGGTTCTTCTGTCCGC
CACGTCTCGAACATGGTCCCTTCA -> ACGTCTCGAACATGGTCCCTTCAT
TCTTCGAATGCTTCATCTACCTAC -> CTTCGAATGCTTCATCTACCTACA
CGTCCGACTATAGGAATCCGTGCT -> GTCCGACTATAGGAATCCGTGCTG
ATGGTCCCTTCATCTCTGCCTAAT -> TGGTCCCTTCATCTCTGCCTAATG
GTGTTGTTGTTGGTCATAGTATTT -> TGTTGTTGTTGGTCATAGTATTTT
GCAAGTCGGAGGTGTGGCAAGGTT -> CAAGTCGGAGGTGTGGCAAGGTTT
AATACGGCTGAGGTTCTCTTTTCG -> ATACGGCTGAGGTTCTCTTTTCGT
CAGTCTTTGGCAGCCTCTTTAGCT -> AGTCTTTGGCAGCCTCTTTAGCTG
ATCCGGTCCCCACATCGTGGTGTA -> TCCGGTCCCCACATCGTGGTGTAT
GATACCCCTGATACCAGCGCATCA -> ATACCCCTGATACCAGCGCATCAT
ACTTTCTCACCGGAGACACGTAAT -> CTTTCTCACCGGAGACACGTAATC
ACACACGGAGGCCGAAAGCATTAT -> CACACGGAGGCCGAAAGCATTATC
GGACCTGCCAACTTCTACGATCTG -> GACCTGCCAACTTCTACGATCTGG
CAACAAAAAGTGCGGTCGCCGTTT -> AACAAAAAGTGCGGTCGCCGTTTT
GCAGCACCTGCCTATATTGTCGTC -> CAGCACCTGCCTATATTGTCGTCG
AGACAAGTAACCTAGTAGGGCCGG -> GACAAGTAACCTAGTAGGGCCGGT
ACTCCCATCAATATATGGGTTGTC -> CTCCCATCAATATATGGGTTGTCC
TCTATGTGATACAATCTAACCCGT -> CTATGTGATACAATCTAACCCGTC
AACTGGACAGAAGTGACTGACACG -> ACTGGACAGAAGTGACTGACACGG
AACACTCCTGCAAGGCCTGGTGTC -> ACACTCCTGCAAGGCCTGGTGTCC
GGGCCGGTGCTTAACACACGGAGG -> GGCCGGTGCTTAACACACGGAGGC
CTATTCCAGCTTTCTTCGAATGCT -> TATTCCAGCTTTCTTCGAATGCTT
ACTAGCCCATCCGGTCCCCACATC -> CTAGCCCATCCGGTCCCCACATCG
CATCTCGCGTACGATATCAATCAC -> ATCTCGCGTACGATATCAATCACT
TTAGTGGCTCCGACCGGAACGGAA -> TAGTGGCTCCGACCGGAACGGAAA
AATGCTTCATCTACCTACAAAAAT -> ATGCTTCATCTACCTACAAAAATA
GGTGCTTAACACACGGAGGCCGAA -> GTGCTTAACACACGGAGGCCGAAA
CTGATACCAGCGCATCATTTGGCC -> TGATACCAGCGCATCATTTGGCCC
TCTGGACCATCGCAGGAGAACAAG -> CTGGACCATCGCAGGAGAACAAGT
TACAGTCTAGGGTGACGTCGCGAT -> ACAGTCTAGGGTGACGTCGCGATT
TGGGAGGCCCGTCCCTCGTAGTCC -> GGGAGGCCCGTCCCTCGTAGTCCC
CATCTACCTACAAAAATACCAGTC -> ATCTACCTACAAAAATACCAGTCA
TCAAAAAGAACATCTTTGCCAGAC -> CAAAAAGAACATCTTTGCCAGACA
TCTCTTTCTTGGCACCACCACCCA -> CTCTTTCTTGGCACCACCACCCAT
AGAGGGGTTCTTCTGTCCGCGACA -> GAGGGGTTCTTCTGTCCGCGACAT
AGTCTTTGGCAGCCTCTTTAGCTG -> GTCTTTGGCAGCCTCTTTAGCTGC
ACGATCTGGACCATCGCAGGAGAA -> CGATCTGGACCATCGCAGGAGAAC
AACGCCTCGCGCACCAGTACTTGG -> ACGCCTCGCGCACCAGTACTTGGT
TTTGGCCCTCTTATTAAGAGGGAC -> TTGGCCCTCTTATTAAGAGGGACC
CTATGGGGAATGCTCAACACTCCT -> TATGGGGAATGCTCAACACTCCTG
GCTGGATTCCGACCATCTCGCGTA -> CTGGATTCCGACCATCTCGCGTAC
GTCAGCAAGTCGGAGGTGTGGCAA -> TCAGCAAGTCGGAGGTGTGGCAAG
CAATTTGCACTACGCCCTGCTTTC -> AATTTGCACTACGCCCTGCTTTCC
CGGGAATGATCAAATAAGTTAGTT -> GGGAATGATCAAATAAGTTAGTTC
CTGCTGCACCCTAGGTTCAAGGAT -> TGCTGCACCCTAGGTTCAAGGATA
CCTGCTGCACCCTAGGTTCAAGGA -> CTGCTGCACCCTAGGTTCAAGGAT
AGGCCCAATGGGTTCGGGCTCCAG -> GGCCCAATGGGTTCGGGCTCCAGG
CACCACCCATCGTGATAGTCACTG -> ACCACCCATCGTGATAGTCACTGG
ACGCATAGGCCGAAGGGCCGCGAA -> CGCATAGGCCGAAGGGCCGCGAAC
TAGGAATCCGTGCTGGAGGGGCAA -> AGGAATCCGTGCTGGAGGGGCAAG
GTTGTTGGTCATAGTATTTTTGAG -> TTGTTGGTCATAGTATTTTTGAGA
CCACCCATCGTGATAGTCACTGGG -> CACCCATCGTGATAGTCACTGGGG
GCGGTCGCCGTTTTCAACTTGTCA -> CGGTCGCCGTTTTCAACTTGTCAG
GTCGCGATTAATGGATCGTTTCCT -> TCGCGATTAATGGATCGTTTCCTT
GCAGAGGGGTTCTTCTGTCCGCGA -> CAGAGGGGTTCTTCTGTCCGCGAC
ATCCAATAAAACTCGGAGCTCTCG -> TCCAATAAAACTCGGAGCTCTCGC
GGTTCAAGGATAACAGAGCGCCTA -> GTTCAAGGATAACAGAGCGCCTAA
CCCCTGATCTCAAAAAGAACATCT -> CCCTGATCTCAAAAAGAACATCTT
CGCGTACGATATCAATCACTGCAT -> GCGTACGATATCAATCACTGCATG
GCAAGGTTTCACTAGTCAATTTGC -> CAAGGTTTCACTAGTCAATTTGCA
GGCACCACCACCCATCGTGATAGT -> GCACCACCACCCATCGTGATAGTC
GTTCAAGGATAACAGAGCGCCTAA -> TTCAAGGATAACAGAGCGCCTAAA
TTTCTTCGAATGCTTCATCTACCT -> TTCTTCGAATGCTTCATCTACCTA
TTCCGACCATCTCGCGTACGATAT -> TCCGACCATCTCGCGTACGATATC
CCTGCAAGGCCTGGTGTCCCCCGA -> CTGCAAGGCCTGGTGTCCCCCGAT
CCATCCAATAAAACTCGGAGCTCT -> CATCCAATAAAACTCGGAGCTCTC
CCTTGACTTTGCCTATAATAACTG -> CTTGACTTTGCCTATAATAACTGC
ATTACGAAGTTATCCGCGGGGCAA -> TTACGAAGTTATCCGCGGGGCAAT
CAAAAAGTGCGGTCGCCGTTTTCA -> AAAAAGTGCGGTCGCCGTTTTCAA
TAATAACTGCGGTGTGCTCGCGAA -> AATAACTGCGGTGTGCTCGCGAAC
ACGAAGGCTTTAGATACACGTCTC -> CGAAGGCTTTAGATACACGTCTCG
ATCGAGCGCTGGAGACATCAACTG -> TCGAGCGCTGGAGACATCAACTGG
CGTACGATATCAATCACTGCATGT -> GTACGATATCAATCACTGCATGTA
ACCCCTGATCTCAAAAAGAACATC -> CCCCTGATCTCAAAAAGAACATCT
GTCAATTTGCACTACGCCCTGCTT -> TCAATTTGCACTACGCCCTGCTTT
GAACACTATTCTTTAAGGCATGCT -> AACACTATTCTTTAAGGCATGCTC
CATCTATGTGATACAATCTAACCC -> ATCTATGTGATACAATCTAACCCG
CGAATGCTTCATCTACCTACAAAA -> GAATGCTTCATCTACCTACAAAAA
CCTCTTTAGCTGCATATAATCGAC -> CTCTTTAGCTGCATATAATCGACG
TTCTTTAAGGCATGCTCTCGTAAG -> TCTTTAAGGCATGCTCTCGTAAGT
CCTTAGTGGCTCCGACCGGAACGG -> CTTAGTGGCTCCGACCGGAACGGA
TGGAGACATCAACTGGACAGAAGT -> GGAGACATCAACTGGACAGAAGTG
AAAAGAACATCTTTGCCAGACAAG -> AAAGAACATCTTTGCCAGACAAGT
GAAGTTATCCGCGGGGCAATCCTC -> AAGTTATCCGCGGGGCAATCCTCT
GCTGAGGTTCTCTTTTCGTCTCCG -> CTGAGGTTCTCTTTTCGTCTCCGA
CCCCCGGATCACTAGGGGCTGGAT -> CCCCGGATCACTAGGGGCTGGATT
AATACGAGGTATTTTTTCTCGTAG -> ATACGAGGTATTTTTTCTCGTAGT
TGAGGTTCTCTTTTCGTCTCCGAA -> GAGGTTCTCTTTTCGTCTCCGAAA
CTGGTCAAAAGATCACTATGCCTT -> TGGTCAAAAGATCACTATGCCTTG
TTGACCCTTCCTGCTGCACCCTAG -> TGACCCTTCCTGCTGCACCCTAGG
GGCAGCCTCTTTAGCTGCATATAA -> GCAGCCTCTTTAGCTGCATATAAT
GGGGAATGCTCAACACTCCTGCAA -> GGGAATGCTCAACACTCCTGCAAG
TTTCTCACCGGAGACACGTAATCA -> TTCTCACCGGAGACACGTAATCAC
GGAGGGGCAAGCCCCCGTAAGGAC -> GAGGGGCAAGCCCCCGTAAGGACG
ACTACCTTAGTGGCTCCGACCGGA -> CTACCTTAGTGGCTCCGACCGGAA
TCCGCGACATGGGAGGCCCGTCCC -> CCGCGACATGGGAGGCCCGTCCCT
CAGCACCTGCCTATATTGTCGTCG -> AGCACCTGCCTATATTGTCGTCGC
ATCCTCTGACAATATAGATAGAGA -> TCCTCTGACAATATAGATAGAGAA
CTGGTGTCCCCCGATAAGACACGG -> TGGTGTCCCCCGATAAGACACGGT
CCATCGTGATAGTCACTGGGGAGA -> CATCGTGATAGTCACTGGGGAGAT
CGGAAATCTTTTAGGGGGACAACA -> GGAAATCTTTTAGGGGGACAACAA
TAGTTCCTGAGCGACCTCAACCTG -> AGTTCCTGAGCGACCTCAACCTGT
TCCGGTCCCCACATCGTGGTGTAT -> CCGGTCCCCACATCGTGGTGTATG
AACACTATTCTTTAAGGCATGCTC -> ACACTATTCTTTAAGGCATGCTCT
CTCCCCCCCGGATCACTAGGGGCT -> TCCCCCCCGGATCACTAGGGGCTG
AGGTCACCCTCCCCCCCGGATCAC -> GGTCACCCTCCCCCCCGGATCACT
CGAACGCCTCGCGCACCAGTACTT -> GAACGCCTCGCGCACCAGTACTTG
GATACAGTCTAGGGTGACGTCGCG -> ATACAGTCTAGGGTGACGTCGCGA
TTAGTTCCTGAGCGACCTCAACCT -> TAGTTCCTGAGCGACCTCAACCTG
GGTCAAAAGATCACTATGCCTTGA -> GTCAAAAGATCACTATGCCTTGAC
AGCAGCACCTGCCTATATTGTCGT -> GCAGCACCTGCCTATATTGTCGTC
CCATATATGTAGCTAGTGTCGCGT -> CATATATGTAGCTAGTGTCGCGTA
TGACCCTTCCTGCTGCACCCTAGG -> GACCCTTCCTGCTGCACCCTAGGT
ATCCATCGCAGAGGGGTTCTTCTG -> TCCATCGCAGAGGGGTTCTTCTGT
CTATAGGAATCCGTGCTGGAGGGG -> TATAGGAATCCGTGCTGGAGGGGC
CACTATGCCTTGACTTTGCCTATA -> ACTATGCCTTGACTTTGCCTATAA
CTCCGAAAGATTCGTCCGACTATA -> TCCGAAAGATTCGTCCGACTATAG
CACCGCAACTTTCTCACCGGAGAC -> ACCGCAACTTTCTCACCGGAGACA
CTCTGCCTAATGACCTTATCTATT -> TCTGCCTAATGACCTTATCTATTC
ATATGTAGCTAGTGTCGCGTAGCG -> TATGTAGCTAGTGTCGCGTAGCGT
TATATGTAGCTAGTGTCGCGTAGC -> ATATGTAGCTAGTGTCGCGTAGCG
TCAGTCTTTGGCAGCCTCTTTAGC -> CAGTCTTTGGCAGCCTCTTTAGCT
CTCGCATGGGGACGATCCAGATTA -> TCGCATGGGGACGATCCAGATTAC
AACTGCGGTGTGCTCGCGAACGCC -> ACTGCGGTGTGCTCGCGAACGCCT
AAGGGCCGCGAACACTATTCTTTA -> AGGGCCGCGAACACTATTCTTTAA
GCTCAACACTCCTGCAAGGCCTGG -> CTCAACACTCCTGCAAGGCCTGGT
AAAAGTGCGGTCGCCGTTTTCAAC -> AAAGTGCGGTCGCCGTTTTCAACT
ATTCGCCTGGGCTGGTCAAAAGAT -> TTCGCCTGGGCTGGTCAAAAGATC
GGGACCTGCCAACTTCTACGATCT -> GGACCTGCCAACTTCTACGATCTG
TCTGACAATATAGATAGAGAACAC -> CTGACAATATAGATAGAGAACACC
ATCAATATATGGGTTGTCCACTAC -> TCAATATATGGGTTGTCCACTACC
GTGGCAAGGTTTCACTAGTCAATT -> TGGCAAGGTTTCACTAGTCAATTT
TTCCAGCTTTCTTCGAATGCTTCA -> TCCAGCTTTCTTCGAATGCTTCAT
TTTCAACTTGTCAGCAAGTCGGAG -> TTCAACTTGTCAGCAAGTCGGAGG
AGGGGCTGGATTCCGACCATCTCG -> GGGGCTGGATTCCGACCATCTCGC
GGCAAGGTTTCACTAGTCAATTTG -> GCAAGGTTTCACTAGTCAATTTGC
GACGATCCAGATTACGAAGTTATC -> ACGATCCAGATTACGAAGTTATCC
GCCTGGTGTCCCCCGATAAGACAC -> CCTGGTGTCCCCCGATAAGACACG
GCAAGGCCTGGTGTCCCCCGATAA -> CAAGGCCTGGTGTCCCCCGATAAG
AAATCTTTTAGGGGGACAACAAAA -> AATCTTTTAGGGGGACAACAAAAA
CAACGATTCGATCAGATCCCATTT -> AACGATTCGATCAGATCCCATTTG
GACCGAAACCCCTGATCTCAAAAA -> ACCGAAACCCCTGATCTCAAAAAG
ATGCCATCATCTATGTGATACAAT -> TGCCATCATCTATGTGATACAATC
TACGAAGTTATCCGCGGGGCAATC -> ACGAAGTTATCCGCGGGGCAATCC
GACTATAGGAATCCGTGCTGGAGG -> ACTATAGGAATCCGTGCTGGAGGG
GCAATACGGCTGAGGTTCTCTTTT -> CAATACGGCTGAGGTTCTCTTTTC
TGTTGTTGTTGGTCATAGTATTTT -> GTTGTTGTTGGTCATAGTATTTTT
AGGAATCCGTGCTGGAGGGGCAAG -> GGAATCCGTGCTGGAGGGGCAAGC
TAACCATATATGTAGCTAGTGTCG -> AACCATATATGTAGCTAGTGTCGC
TATCCGCGGGGCAATCCTCTGACA -> ATCCGCGGGGCAATCCTCTGACAA
ACTTGGTTTGATACAGTCTAGGGT -> CTTGGTTTGATACAGTCTAGGGTG
ATAAGTTAGTTCCTGAGCGACCTC -> TAAGTTAGTTCCTGAGCGACCTCA
AGAGAACACCGGGAATGATCAAAT -> GAGAACACCGGGAATGATCAAATA
GCCCTCTTATTAAGAGGGACCTGC -> CCCTCTTATTAAGAGGGACCTGCC
GGGCCGCGAACACTATTCTTTAAG -> GGCCGCGAACACTATTCTTTAAGG
GTATCCATCGCAGAGGGGTTCTTC -> TATCCATCGCAGAGGGGTTCTTCT
CCGACCGGAACGGAAATCTTTTAG -> CGACCGGAACGGAAATCTTTTAGG
AGGGGCAAGCCCCCGTAAGGACGT -> GGGGCAAGCCCCCGTAAGGACGTG
CAAATAAGTTAGTTCCTGAGCGAC -> AAATAAGTTAGTTCCTGAGCGACC
CTCGATACCCCTGATACCAGCGCA -> TCGATACCCCTGATACCAGCGCAT
TTATCAGTCTTTGGCAGCCTCTTT -> TATCAGTCTTTGGCAGCCTCTTTA
TAACCCGTCCGTCTCTTTCTTGGC -> AACCCGTCCGTCTCTTTCTTGGCA
CTGAGCGACCTCAACCTGTTACTC -> TGAGCGACCTCAACCTGTTACTCC
TGCCTATAATAACTGCGGTGTGCT -> GCCTATAATAACTGCGGTGTGCTC
TCCCATCAATATATGGGTTGTCCA -> CCCATCAATATATGGGTTGTCCAC
TTGTTGTTGGTCATAGTATTTTTG -> TGTTGTTGGTCATAGTATTTTTGA
GGATTCCGACCATCTCGCGTACGA -> GATTCCGACCATCTCGCGTACGAT
GATTAATGGATCGTTTCCTTTAAA -> ATTAATGGATCGTTTCCTTTAAAC
GATACACGTCTCGAACATGGTCCC -> ATACACGTCTCGAACATGGTCCCT
AAAAATACCAGTCAACCAGATTCG -> AAAATACCAGTCAACCAGATTCGC
CGTGGTGTATGCCATCATCTATGT -> GTGGTGTATGCCATCATCTATGTG
CGTCGCAACGATTCGATCAGATCC -> GTCGCAACGATTCGATCAGATCCC
TATTCTTTAAGGCATGCTCTCGTA -> ATTCTTTAAGGCATGCTCTCGTAA
GCTGCATATAATCGACGAAGGCTT -> CTGCATATAATCGACGAAGGCTTT
CTACGCCCTGCTTTCCGATTGGAT -> TACGCCCTGCTTTCCGATTGGATT
TGGTTTGATACAGTCTAGGGTGAC -> GGTTTGATACAGTCTAGGGTGACG
ACGATTCGATCAGATCCCATTTGG -> CGATTCGATCAGATCCCATTTGGA
CTAGTAGGGCCGGTGCTTAACACA -> TAGTAGGGCCGGTGCTTAACACAC
CTTATTAAGAGGGACCTGCCAACT -> TTATTAAGAGGGACCTGCCAACTT
GTTATCCGCGGGGCAATCCTCTGA -> TTATCCGCGGGGCAATCCTCTGAC
AGTACTTGGTTTGATACAGTCTAG -> GTACTTGGTTTGATACAGTCTAGG
GGACGCTGCTCTTGCCAGGCCCAA -> GACGCTGCTCTTGCCAGGCCCAAT
GCTGGAGACATCAACTGGACAGAA -> CTGGAGACATCAACTGGACAGAAG
TGGTCAAAAGATCACTATGCCTTG -> GGTCAAAAGATCACTATGCCTTGA
CTGGACAGAAGTGACTGACACGGT -> TGGACAGAAGTGACTGACACGGTG
GACCCTTCCTGCTGCACCCTAGGT -> ACCCTTCCTGCTGCACCCTAGGTT
CGTCCCTCGTAGTCCCCCAGCAGC -> GTCCCTCGTAGTCCCCCAGCAGCA
CTTGCCAGGCCCAATGGGTTCGGG -> TTGCCAGGCCCAATGGGTTCGGGC
GACCTCAACCTGTTACTCCCATCA -> ACCTCAACCTGTTACTCCCATCAA
GCTGGAGGGGCAAGCCCCCGTAAG -> CTGGAGGGGCAAGCCCCCGTAAGG
GCGTGACTACTCGATACCCCTGAT -> CGTGACTACTCGATACCCCTGATA
ATATAATCGACGAAGGCTTTAGAT -> TATAATCGACGAAGGCTTTAGATA
TAAGTTAGTTCCTGAGCGACCTCA -> AAGTTAGTTCCTGAGCGACCTCAA
ATCTCGCGTACGATATCAATCACT -> TCTCGCGTACGATATCAATCACTG
GGTTTGATACAGTCTAGGGTGACG -> GTTTGATACAGTCTAGGGTGACGT
TCGCAACGATTCGATCAGATCCCA -> CGCAACGATTCGATCAGATCCCAT
AATCACGCATAGGCCGAAGGGCCG -> ATCACGCATAGGCCGAAGGGCCGC
TGTCGCGTAGCGTGACTACTCGAT -> GTCGCGTAGCGTGACTACTCGATA
CACTAGGGGCTGGATTCCGACCAT -> ACTAGGGGCTGGATTCCGACCATC
GTCCCTTCATCTCTGCCTAATGAC -> TCCCTTCATCTCTGCCTAATGACC
ACTTCTACGATCTGGACCATCGCA -> CTTCTACGATCTGGACCATCGCAG
TATGCCTTGACTTTGCCTATAATA -> ATGCCTTGACTTTGCCTATAATAA
TTGGTCATAGTATTTTTGAGACCG -> TGGTCATAGTATTTTTGAGACCGA
ACCGCAATACGGCTGAGGTTCTCT -> CCGCAATACGGCTGAGGTTCTCTT
TCTCTTTTCGTCTCCGAAAGATTC -> CTCTTTTCGTCTCCGAAAGATTCG
TCAACTTGTCAGCAAGTCGGAGGT -> CAACTTGTCAGCAAGTCGGAGGTG
ATATATGGGTTGTCCACTACCTTA -> TATATGGGTTGTCCACTACCTTAG
AATTTGCACTACGCCCTGCTTTCC -> ATTTGCACTACGCCCTGCTTTCCG
TTGAGACCGAAACCCCTGATCTCA -> TGAGACCGAAACCCCTGATCTCAA
AGTCTAGGGTGACGTCGCGATTAA -> GTCTAGGGTGACGTCGCGATTAAT
ACACGTAATCACGCATAGGCCGAA -> CACGTAATCACGCATAGGCCGAAG
GAAATCTTTTAGGGGGACAACAAA -> AAATCTTTTAGGGGGACAACAAAA
CATAGGCCGAAGGGCCGCGAACAC -> ATAGGCCGAAGGGCCGCGAACACT
TCTTATTAAGAGGGACCTGCCAAC -> CTTATTAAGAGGGACCTGCCAACT
AGTCCCCCAGCAGCACCTGCCTAT -> GTCCCCCAGCAGCACCTGCCTATA
TCAACACTCCTGCAAGGCCTGGTG -> CAACACTCCTGCAAGGCCTGGTGT
TCCAGATTACGAAGTTATCCGCGG -> CCAGATTACGAAGTTATCCGCGGG
CTGGGCTGGTCAAAAGATCACTAT -> TGGGCTGGTCAAAAGATCACTATG
ATCATTTGGCCCTCTTATTAAGAG -> TCATTTGGCCCTCTTATTAAGAGG
AGCGCCTAAAAAAATACGAGGTAT -> GCGCCTAAAAAAATACGAGGTATT
GGGGGACAACAAAAAGTGCGGTCG -> GGGGACAACAAAAAGTGCGGTCGC
CGCAATACGGCTGAGGTTCTCTTT -> GCAATACGGCTGAGGTTCTCTTTT
TATTTTTTCTCGTAGTTCTGCGTC -> ATTTTTTCTCGTAGTTCTGCGTCA
ACAGAGCGCCTAAAAAAATACGAG -> CAGAGCGCCTAAAAAAATACGAGG
ACGGAAATCTTTTAGGGGGACAAC -> CGGAAATCTTTTAGGGGGACAACA
AGATACACGTCTCGAACATGGTCC -> GATACACGTCTCGAACATGGTCCC
AGCATTATCAGTCTTTGGCAGCCT -> GCATTATCAGTCTTTGGCAGCCTC
CTGTGTTGTTGTTGGTCATAGTAT -> TGTGTTGTTGTTGGTCATAGTATT
GTGGATAAACGGGCACTAGCCCAT -> TGGATAAACGGGCACTAGCCCATC
CCGTAAGGACGTGGATAAACGGGC -> CGTAAGGACGTGGATAAACGGGCA
AGATTCGCCTGGGCTGGTCAAAAG -> GATTCGCCTGGGCTGGTCAAAAGA
TTCATCTACCTACAAAAATACCAG -> TCATCTACCTACAAAAATACCAGT
TTTGGCAGCCTCTTTAGCTGCATA -> TTGGCAGCCTCTTTAGCTGCATAT
AAAAAGTGCGGTCGCCGTTTTCAA -> AAAAGTGCGGTCGCCGTTTTCAAC
GACGAAGGCTTTAGATACACGTCT -> ACGAAGGCTTTAGATACACGTCTC
CTATGCCTTGACTTTGCCTATAAT -> TATGCCTTGACTTTGCCTATAATA
AACTTGTCAGCAAGTCGGAGGTGT -> ACTTGTCAGCAAGTCGGAGGTGTG
CCGAAGGGCCGCGAACACTATTCT -> CGAAGGGCCGCGAACACTATTCTT
GCCAACTTCTACGATCTGGACCAT -> CCAACTTCTACGATCTGGACCATC
GTCGTCGCAACGATTCGATCAGAT -> TCGTCGCAACGATTCGATCAGATC
GACCATCTCGCGTACGATATCAAT -> ACCATCTCGCGTACGATATCAATC
TGCTGGAGGGGCAAGCCCCCGTAA -> GCTGGAGGGGCAAGCCCCCGTAAG
TCTATTCCAGCTTTCTTCGAATGC -> CTATTCCAGCTTTCTTCGAATGCT
CACGGTAACCATATATGTAGCTAG -> ACGGTAACCATATATGTAGCTAGT
CAGCGCATCATTTGGCCCTCTTAT -> AGCGCATCATTTGGCCCTCTTATT
TCCAATAAAACTCGGAGCTCTCGC -> CCAATAAAACTCGGAGCTCTCGCA
AACATGGTCCCTTCATCTCTGCCT -> ACATGGTCCCTTCATCTCTGCCTA
GGATAACAGAGCGCCTAAAAAAAT -> GATAACAGAGCGCCTAAAAAAATA
TTCAAGGATAACAGAGCGCCTAAA -> TCAAGGATAACAGAGCGCCTAAAA
GTCTCGAACATGGTCCCTTCATCT -> TCTCGAACATGGTCCCTTCATCTC
ACACTCCTGCAAGGCCTGGTGTCC -> CACTCCTGCAAGGCCTGGTGTCCC
TGACACGGTGCTGTGTTGTTGTTG -> GACACGGTGCTGTGTTGTTGTTGG
GCTTTCTTCGAATGCTTCATCTAC -> CTTTCTTCGAATGCTTCATCTACC
TCGCCGTTTTCAACTTGTCAGCAA -> CGCCGTTTTCAACTTGTCAGCAAG
AGGATAACAGAGCGCCTAAAAAAA -> GGATAACAGAGCGCCTAAAAAAAT
CACGTAATCACGCATAGGCCGAAG -> ACGTAATCACGCATAGGCCGAAGG
GCTCTCGTAAGTTTTACATTCGAT -> CTCTCGTAAGTTTTACATTCGATG
CTGGATTCCGACCATCTCGCGTAC -> TGGATTCCGACCATCTCGCGTACG
TTAGCTGCATATAATCGACGAAGG -> TAGCTGCATATAATCGACGAAGGC
ATAAGACACGGTAACCATATATGT -> TAAGACACGGTAACCATATATGTA
CGCCTGGGCTGGTCAAAAGATCAC -> GCCTGGGCTGGTCAAAAGATCACT
GGACAACAAAAAGTGCGGTCGCCG -> GACAACAAAAAGTGCGGTCGCCGT
GCAGCCTCTTTAGCTGCATATAAT -> CAGCCTCTTTAGCTGCATATAATC
TCAATATATGGGTTGTCCACTACC -> CAATATATGGGTTGTCCACTACCT
GGCTGGATTCCGACCATCTCGCGT -> GCTGGATTCCGACCATCTCGCGTA
CTACCTTAGTGGCTCCGACCGGAA -> TACCTTAGTGGCTCCGACCGGAAC
ACGCCCTGCTTTCCGATTGGATTG -> CGCCCTGCTTTCCGATTGGATTGG
CCTTGACACCGCAACTTTCTCACC -> CTTGACACCGCAACTTTCTCACCG
ATGTGATACAATCTAACCCGTCCG -> TGTGATACAATCTAACCCGTCCGT
TACAAAAATACCAGTCAACCAGAT -> ACAAAAATACCAGTCAACCAGATT
CCCCGATAAGACACGGTAACCATA -> CCCGATAAGACACGGTAACCATAT
CAGGCCCAATGGGTTCGGGCTCCA -> AGGCCCAATGGGTTCGGGCTCCAG
CGCCTCGCGCACCAGTACTTGGTT -> GCCTCGCGCACCAGTACTTGGTTT
CGGAGACACGTAATCACGCATAGG -> GGAGACACGTAATCACGCATAGGC
CGCAGGAGAACAAGTTGACCCTTC -> GCAGGAGAACAAGTTGACCCTTCC
CCATCGCAGAGGGGTTCTTCTGTC -> CATCGCAGAGGGGTTCTTCTGTCC
GGGTTCGGGCTCCAGGTCACCCTC -> GGTTCGGGCTCCAGGTCACCCTCC
CCTCAACCTGTTACTCCCATCAAT -> CTCAACCTGTTACTCCCATCAATA
TCTCACCGGAGACACGTAATCACG -> CTCACCGGAGACACGTAATCACGC
ATCTATGTGATACAATCTAACCCG -> TCTATGTGATACAATCTAACCCGT
CTTCTGTCCGCGACATGGGAGGCC -> TTCTGTCCGCGACATGGGAGGCCC
CATCAACTGGACAGAAGTGACTGA -> ATCAACTGGACAGAAGTGACTGAC
CGCGAACGCCTCGCGCACCAGTAC -> GCGAACGCCTCGCGCACCAGTACT
TCATAGTATTTTTGAGACCGAAAC -> CATAGTATTTTTGAGACCGAAACC
AAAGAACATCTTTGCCAGACAAGT -> AAGAACATCTTTGCCAGACAAGTA
ATTCGTCCGACTATAGGAATCCGT -> TTCGTCCGACTATAGGAATCCGTG
CTTTGGCAGCCTCTTTAGCTGCAT -> TTTGGCAGCCTCTTTAGCTGCATA
TTGGCAGCCTCTTTAGCTGCATAT -> TGGCAGCCTCTTTAGCTGCATATA
GAATCCGTGCTGGAGGGGCAAGCC -> AATCCGTGCTGGAGGGGCAAGCCC
CCTGATCTCAAAAAGAACATCTTT -> CTGATCTCAAAAAGAACATCTTTG
GCATGTATCCATCGCAGAGGGGTT -> CATGTATCCATCGCAGAGGGGTTC
CCTATATTGTCGTCGCAACGATTC -> CTATATTGTCGTCGCAACGATTCG
TCTTTAAGGCATGCTCTCGTAAGT -> CTTTAAGGCATGCTCTCGTAAGTT
GACCTTATCTATTCCAGCTTTCTT -> ACCTTATCTATTCCAGCTTTCTTC
GGGGACGATCCAGATTACGAAGTT -> GGGACGATCCAGATTACGAAGTTA
GGTTTCACTAGTCAATTTGCACTA -> GTTTCACTAGTCAATTTGCACTAC
ATCCCATTTGGAATCCATCCAATA -> TCCCATTTGGAATCCATCCAATAA
GTGATAGTCACTGGGGAGATGTAC -> TGATAGTCACTGGGGAGATGTACC
GTTCCTGAGCGACCTCAACCTGTT -> TTCCTGAGCGACCTCAACCTGTTA
CGAAAGCATTATCAGTCTTTGGCA -> GAAAGCATTATCAGTCTTTGGCAG
AAGACACGGTAACCATATATGTAG -> AGACACGGTAACCATATATGTAGC
GATCGTTTCCTTTAAACAGTGCTA -> ATCGTTTCCTTTAAACAGTGCTAT
ACTAGGGGCTGGATTCCGACCATC -> CTAGGGGCTGGATTCCGACCATCT
CCCCAGCAGCACCTGCCTATATTG -> CCCAGCAGCACCTGCCTATATTGT
AACGATTCGATCAGATCCCATTTG -> ACGATTCGATCAGATCCCATTTGG
GTAAGTTTTACATTCGATGGACGC -> TAAGTTTTACATTCGATGGACGCT
TTCCTTTAAACAGTGCTATGGGGA -> TCCTTTAAACAGTGCTATGGGGAA
AGAGCGCCTAAAAAAATACGAGGT -> GAGCGCCTAAAAAAATACGAGGTA
GGCAATCCTCTGACAATATAGATA -> GCAATCCTCTGACAATATAGATAG
ACGAGGTATTTTTTCTCGTAGTTC -> CGAGGTATTTTTTCTCGTAGTTCT
AAGTTAGTTCCTGAGCGACCTCAA -> AGTTAGTTCCTGAGCGACCTCAAC
TCGATCAGATCCCATTTGGAATCC -> CGATCAGATCCCATTTGGAATCCA
CGACCGGAACGGAAATCTTTTAGG -> GACCGGAACGGAAATCTTTTAGGG
CTCTTTTCGTCTCCGAAAGATTCG -> TCTTTTCGTCTCCGAAAGATTCGT
GGTTCTCTTTTCGTCTCCGAAAGA -> GTTCTCTTTTCGTCTCCGAAAGAT
CCAATGGGTTCGGGCTCCAGGTCA -> CAATGGGTTCGGGCTCCAGGTCAC
TGCTTTCCGATTGGATTGGGAACC -> GCTTTCCGATTGGATTGGGAACCG
ACCATCTCGCGTACGATATCAATC -> CCATCTCGCGTACGATATCAATCA
ACATCTTTGCCAGACAAGTAACCT -> CATCTTTGCCAGACAAGTAACCTA
GATACCAGCGCATCATTTGGCCCT -> ATACCAGCGCATCATTTGGCCCTC
TACCAGTCAACCAGATTCGCCTGG -> ACCAGTCAACCAGATTCGCCTGGG
ATGGGGACGATCCAGATTACGAAG -> TGGGGACGATCCAGATTACGAAGT
ACCGGGAATGATCAAATAAGTTAG -> CCGGGAATGATCAAATAAGTTAGT
ACCCTAGGTTCAAGGATAACAGAG -> CCCTAGGTTCAAGGATAACAGAGC
TGATACAATCTAACCCGTCCGTCT -> GATACAATCTAACCCGTCCGTCTC
CGTGCTGGAGGGGCAAGCCCCCGT -> GTGCTGGAGGGGCAAGCCCCCGTA
GTGTGCTCGCGAACGCCTCGCGCA -> TGTGCTCGCGAACGCCTCGCGCAC
CCTAATGACCTTATCTATTCCAGC -> CTAATGACCTTATCTATTCCAGCT
ATCCATCCAATAAAACTCGGAGCT -> TCCATCCAATAAAACTCGGAGCTC
TCCCATTTGGAATCCATCCAATAA -> CCCATTTGGAATCCATCCAATAAA
TTTAAGGCATGCTCTCGTAAGTTT -> TTAAGGCATGCTCTCGTAAGTTTT
CCCTTCCTGCTGCACCCTAGGTTC -> CCTTCCTGCTGCACCCTAGGTTCA
CGTAATCACGCATAGGCCGAAGGG -> GTAATCACGCATAGGCCGAAGGGC
GTTGTTGTTGGTCATAGTATTTTT -> TTGTTGTTGGTCATAGTATTTTTG
TAAGGACGTGGATAAACGGGCACT -> AAGGACGTGGATAAACGGGCACTA
TTCTACGATCTGGACCATCGCAGG -> TCTACGATCTGGACCATCGCAGGA
TTAAGGCATGCTCTCGTAAGTTTT -> TAAGGCATGCTCTCGTAAGTTTTA
CTGGGGAGATGTACCTTGACACCG -> TGGGGAGATGTACCTTGACACCGC
CCCATCAATATATGGGTTGTCCAC -> CCATCAATATATGGGTTGTCCACT
CGTGATAGTCACTGGGGAGATGTA -> GTGATAGTCACTGGGGAGATGTAC
GTCAAAAGATCACTATGCCTTGAC -> TCAAAAGATCACTATGCCTTGACT
CATCGTGGTGTATGCCATCATCTA -> ATCGTGGTGTATGCCATCATCTAT
ACCCATCGTGATAGTCACTGGGGA -> CCCATCGTGATAGTCACTGGGGAG
CTATATTGTCGTCGCAACGATTCG -> TATATTGTCGTCGCAACGATTCGA
CGAAATCGAGCGCTGGAGACATCA -> GAAATCGAGCGCTGGAGACATCAA
CCCGATAAGACACGGTAACCATAT -> CCGATAAGACACGGTAACCATATA
ACAAAAAGTGCGGTCGCCGTTTTC -> CAAAAAGTGCGGTCGCCGTTTTCA
TGCTGTGTTGTTGTTGGTCATAGT -> GCTGTGTTGTTGTTGGTCATAGTA
TTTACATTCGATGGACGCTGCTCT -> TTACATTCGATGGACGCTGCTCTT
CTGTCCGCGACATGGGAGGCCCGT -> TGTCCGCGACATGGGAGGCCCGTC
CCAGGCCCAATGGGTTCGGGCTCC -> CAGGCCCAATGGGTTCGGGCTCCA
CAAGTTGACCCTTCCTGCTGCACC -> AAGTTGACCCTTCCTGCTGCACCC
CAGTGCTATGGGGAATGCTCAACA -> AGTGCTATGGGGAATGCTCAACAC
GCTCTCGCATGGGGACGATCCAGA -> CTCTCGCATGGGGACGATCCAGAT
ATAGTCACTGGGGAGATGTACCTT -> TAGTCACTGGGGAGATGTACCTTG
GTCCACTACCTTAGTGGCTCCGAC -> TCCACTACCTTAGTGGCTCCGACC
AAAAAATACGAGGTATTTTTTCTC -> AAAAATACGAGGTATTTTTTCTCG
TGGATCGTTTCCTTTAAACAGTGC -> GGATCGTTTCCTTTAAACAGTGCT
CACCGGAGACACGTAATCACGCAT -> ACCGGAGACACGTAATCACGCATA
CCCGGATCACTAGGGGCTGGATTC -> CCGGATCACTAGGGGCTGGATTCC
GTTCTTCTGTCCGCGACATGGGAG -> TTCTTCTGTCCGCGACATGGGAGG
CACCCTCCCCCCCGGATCACTAGG -> ACCCTCCCCCCCGGATCACTAGGG
TATGTAGCTAGTGTCGCGTAGCGT -> ATGTAGCTAGTGTCGCGTAGCGTG
CCATCCGGTCCCCACATCGTGGTG -> CATCCGGTCCCCACATCGTGGTGT
GATACAATCTAACCCGTCCGTCTC -> ATACAATCTAACCCGTCCGTCTCT
ATCCAGATTACGAAGTTATCCGCG -> TCCAGATTACGAAGTTATCCGCGG
GTACTTGGTTTGATACAGTCTAGG -> TACTTGGTTTGATACAGTCTAGGG
CGGAACGGAAATCTTTTAGGGGGA -> GGAACGGAAATCTTTTAGGGGGAC
CGGTCGCCGTTTTCAACTTGTCAG -> GGTCGCCGTTTTCAACTTGTCAGC
CGATTAATGGATCGTTTCCTTTAA -> GATTAATGGATCGTTTCCTTTAAA
TACTCCCATCAATATATGGGTTGT -> ACTCCCATCAATATATGGGTTGTC
CAACTTTCTCACCGGAGACACGTA -> AACTTTCTCACCGGAGACACGTAA
ATACAATCTAACCCGTCCGTCTCT -> TACAATCTAACCCGTCCGTCTCTT
TTGATACAGTCTAGGGTGACGTCG -> TGATACAGTCTAGGGTGACGTCGC
CCGGATCACTAGGGGCTGGATTCC -> CGGATCACTAGGGGCTGGATTCCG
TGATACCAGCGCATCATTTGGCCC -> GATACCAGCGCATCATTTGGCCCT
GGCTCCGACCGGAACGGAAATCTT -> GCTCCGACCGGAACGGAAATCTTT
GGTTCTTCTGTCCGCGACATGGGA -> GTTCTTCTGTCCGCGACATGGGAG
CCAGATTCGCCTGGGCTGGTCAAA -> CAGATTCGCCTGGGCTGGTCAAAA
TCTCGTAAGTTTTACATTCGATGG -> CTCGTAAGTTTTACATTCGATGGA
GATGTACCTTGACACCGCAACTTT -> ATGTACCTTGACACCGCAACTTTC
TCGTAAGTTTTACATTCGATGGAC -> CGTAAGTTTTACATTCGATGGACG
TCACCCTCCCCCCCGGATCACTAG -> CACCCTCCCCCCCGGATCACTAGG
ACTACTCGATACCCCTGATACCAG -> CTACTCGATACCCCTGATACCAGC
TTCTCTTTTCGTCTCCGAAAGATT -> TCTCTTTTCGTCTCCGAAAGATTC
TCAAATAAGTTAGTTCCTGAGCGA -> CAAATAAGTTAGTTCCTGAGCGAC
GATTGGATTGGGAACCGCAATAAC -> ATTGGATTGGGAACCGCAATAACA
CACATCGTGGTGTATGCCATCATC -> ACATCGTGGTGTATGCCATCATCT
GGGCAATCCTCTGACAATATAGAT -> GGCAATCCTCTGACAATATAGATA
TACTCGATACCCCTGATACCAGCG -> ACTCGATACCCCTGATACCAGCGC
GTTAGTTCCTGAGCGACCTCAACC -> TTAGTTCCTGAGCGACCTCAACCT
CTTTAGCTGCATATAATCGACGAA -> TTTAGCTGCATATAATCGACGAAG
TCAATTTGCACTACGCCCTGCTTT -> CAATTTGCACTACGCCCTGCTTTC
GGATCGTTTCCTTTAAACAGTGCT -> GATCGTTTCCTTTAAACAGTGCTA
AGACACGGTAACCATATATGTAGC -> GACACGGTAACCATATATGTAGCT
GTTTTCAACTTGTCAGCAAGTCGG -> TTTTCAACTTGTCAGCAAGTCGGA
AAAGATCACTATGCCTTGACTTTG -> AAGATCACTATGCCTTGACTTTGC
GGACGTGGATAAACGGGCACTAGC -> GACGTGGATAAACGGGCACTAGCC
AGTCACTGGGGAGATGTACCTTGA -> GTCACTGGGGAGATGTACCTTGAC
TTTCGTCTCCGAAAGATTCGTCCG -> TTCGTCTCCGAAAGATTCGTCCGA
CCTGAGCGACCTCAACCTGTTACT -> CTGAGCGACCTCAACCTGTTACTC
GGCCGAAAGCATTATCAGTCTTTG -> GCCGAAAGCATTATCAGTCTTTGG
TACGAGGTATTTTTTCTCGTAGTT -> ACGAGGTATTTTTTCTCGTAGTTC
CGGGGCAATCCTCTGACAATATAG -> GGGGCAATCCTCTGACAATATAGA
CCTCTGACAATATAGATAGAGAAC -> CTCTGACAATATAGATAGAGAACA
GGTCATAGTATTTTTGAGACCGAA -> GTCATAGTATTTTTGAGACCGAAA
GGCTGAGGTTCTCTTTTCGTCTCC -> GCTGAGGTTCTCTTTTCGTCTCCG
ACTGGACAGAAGTGACTGACACGG -> CTGGACAGAAGTGACTGACACGGT
GCTGGTCAAAAGATCACTATGCCT -> CTGGTCAAAAGATCACTATGCCTT
GACAAGTAACCTAGTAGGGCCGGT -> ACAAGTAACCTAGTAGGGCCGGTG
CAACCAGATTCGCCTGGGCTGGTC -> AACCAGATTCGCCTGGGCTGGTCA
GTGCTATGGGGAATGCTCAACACT -> TGCTATGGGGAATGCTCAACACTC
ATCTTTTAGGGGGACAACAAAAAG -> TCTTTTAGGGGGACAACAAAAAGT
AAGGCCTGGTGTCCCCCGATAAGA -> AGGCCTGGTGTCCCCCGATAAGAC
CTAGGTTCAAGGATAACAGAGCGC -> TAGGTTCAAGGATAACAGAGCGCC
AGTAGGGCCGGTGCTTAACACACG -> GTAGGGCCGGTGCTTAACACACGG
ATTGTCGTCGCAACGATTCGATCA -> TTGTCGTCGCAACGATTCGATCAG
TAGCTAGTGTCGCGTAGCGTGACT -> AGCTAGTGTCGCGTAGCGTGACTA
CTTCCTGCTGCACCCTAGGTTCAA -> TTCCTGCTGCACCCTAGGTTCAAG
TAGTCCCCCAGCAGCACCTGCCTA -> AGTCCCCCAGCAGCACCTGCCTAT
CAGAGCGCCTAAAAAAATACGAGG -> AGAGCGCCTAAAAAAATACGAGGT
TAGTCAATTTGCACTACGCCCTGC -> AGTCAATTTGCACTACGCCCTGCT
TCCTTTAAACAGTGCTATGGGGAA -> CCTTTAAACAGTGCTATGGGGAAT
CCTTCATCTCTGCCTAATGACCTT -> CTTCATCTCTGCCTAATGACCTTA
CCCTCCCCCCCGGATCACTAGGGG -> CCTCCCCCCCGGATCACTAGGGGC
GCCCAATGGGTTCGGGCTCCAGGT -> CCCAATGGGTTCGGGCTCCAGGTC
TACATTCGATGGACGCTGCTCTTG -> ACATTCGATGGACGCTGCTCTTGC
GTCACCGCAATACGGCTGAGGTTC -> TCACCGCAATACGGCTGAGGTTCT
AATCGAGCGCTGGAGACATCAACT -> ATCGAGCGCTGGAGACATCAACTG
CATCGCAGGAGAACAAGTTGACCC -> ATCGCAGGAGAACAAGTTGACCCT
CCGTTTTCAACTTGTCAGCAAGTC -> CGTTTTCAACTTGTCAGCAAGTCG
ACATCAACTGGACAGAAGTGACTG -> CATCAACTGGACAGAAGTGACTGA
ACACGTCTCGAACATGGTCCCTTC -> CACGTCTCGAACATGGTCCCTTCA
TATATGGGTTGTCCACTACCTTAG -> ATATGGGTTGTCCACTACCTTAGT
TCTGCCTAATGACCTTATCTATTC -> CTGCCTAATGACCTTATCTATTCC
ACACGGAGGCCGAAAGCATTATCA -> CACGGAGGCCGAAAGCATTATCAG
CAATCACTGCATGTATCCATCGCA -> AATCACTGCATGTATCCATCGCAG
GCCTGGGCTGGTCAAAAGATCACT -> CCTGGGCTGGTCAAAAGATCACTA
GGCCCGTCCCTCGTAGTCCCCCAG -> GCCCGTCCCTCGTAGTCCCCCAGC
CGAACACTATTCTTTAAGGCATGC -> GAACACTATTCTTTAAGGCATGCT
ACGTCTCGAACATGGTCCCTTCAT -> CGTCTCGAACATGGTCCCTTCATC
GAGGGGCAAGCCCCCGTAAGGACG -> AGGGGCAAGCCCCCGTAAGGACGT
TCAACTGGACAGAAGTGACTGACA -> CAACTGGACAGAAGTGACTGACAC
CCAGTACTTGGTTTGATACAGTCT -> CAGTACTTGGTTTGATACAGTCTA
GTATTTTTGAGACCGAAACCCCTG -> TATTTTTGAGACCGAAACCCCTGA
TTCGTCTCCGAAAGATTCGTCCGA -> TCGTCTCCGAAAGATTCGTCCGAC
CCCATTTGGAATCCATCCAATAAA -> CCATTTGGAATCCATCCAATAAAA
CCATCGCAGGAGAACAAGTTGACC -> CATCGCAGGAGAACAAGTTGACCC
TGGTCCCTTCATCTCTGCCTAATG -> GGTCCCTTCATCTCTGCCTAATGA
TACCAGCGCATCATTTGGCCCTCT -> ACCAGCGCATCATTTGGCCCTCTT
TGCTTCATCTACCTACAAAAATAC -> GCTTCATCTACCTACAAAAATACC
AAAGTGCGGTCGCCGTTTTCAACT -> AAGTGCGGTCGCCGTTTTCAACTT
GTCGCAACGATTCGATCAGATCCC -> TCGCAACGATTCGATCAGATCCCA
CCAGCTTTCTTCGAATGCTTCATC -> CAGCTTTCTTCGAATGCTTCATCT
AGACATCAACTGGACAGAAGTGAC -> GACATCAACTGGACAGAAGTGACT
CGCGATTAATGGATCGTTTCCTTT -> GCGATTAATGGATCGTTTCCTTTA
GCCCCCGTAAGGACGTGGATAAAC -> CCCCCGTAAGGACGTGGATAAACG
TCCCCACATCGTGGTGTATGCCAT -> CCCCACATCGTGGTGTATGCCATC
TCTCCGAAAGATTCGTCCGACTAT -> CTCCGAAAGATTCGTCCGACTATA
ATCTCAAAAAGAACATCTTTGCCA -> TCTCAAAAAGAACATCTTTGCCAG
GGGAATGATCAAATAAGTTAGTTC -> GGAATGATCAAATAAGTTAGTTCC
TGTACCTTGACACCGCAACTTTCT -> GTACCTTGACACCGCAACTTTCTC
CACCGGGAATGATCAAATAAGTTA -> ACCGGGAATGATCAAATAAGTTAG
CCCATCGTGATAGTCACTGGGGAG -> CCATCGTGATAGTCACTGGGGAGA
ACCCTCCCCCCCGGATCACTAGGG -> CCCTCCCCCCCGGATCACTAGGGG
GGTCCCCACATCGTGGTGTATGCC -> GTCCCCACATCGTGGTGTATGCCA
CTTCATCTCTGCCTAATGACCTTA -> TTCATCTCTGCCTAATGACCTTAT
GTCATAGTATTTTTGAGACCGAAA -> TCATAGTATTTTTGAGACCGAAAC
AGTTATCCGCGGGGCAATCCTCTG -> GTTATCCGCGGGGCAATCCTCTGA
CCCAATGGGTTCGGGCTCCAGGTC -> CCAATGGGTTCGGGCTCCAGGTCA
AACAGTGCTATGGGGAATGCTCAA -> ACAGTGCTATGGGGAATGCTCAAC
TTAGGGGGACAACAAAAAGTGCGG -> TAGGGGGACAACAAAAAGTGCGGT
TTCTTGGCACCACCACCCATCGTG -> TCTTGGCACCACCACCCATCGTGA
CACCCATCGTGATAGTCACTGGGG -> ACCCATCGTGATAGTCACTGGGGA
GTTGACCCTTCCTGCTGCACCCTA -> TTGACCCTTCCTGCTGCACCCTAG
TAACCTAGTAGGGCCGGTGCTTAA -> AACCTAGTAGGGCCGGTGCTTAAC
AAAAATACGAGGTATTTTTTCTCG -> AAAATACGAGGTATTTTTTCTCGT
ACTATGCCTTGACTTTGCCTATAA -> CTATGCCTTGACTTTGCCTATAAT
CCTTCCTGCTGCACCCTAGGTTCA -> CTTCCTGCTGCACCCTAGGTTCAA
TTTAGATACACGTCTCGAACATGG -> TTAGATACACGTCTCGAACATGGT
ATAAAACTCGGAGCTCTCGCATGG -> TAAAACTCGGAGCTCTCGCATGGG
TGGATTCCGACCATCTCGCGTACG -> GGATTCCGACCATCTCGCGTACGA
CTACTCGATACCCCTGATACCAGC -> TACTCGATACCCCTGATACCAGCG
TGGTCATAGTATTTTTGAGACCGA -> GGTCATAGTATTTTTGAGACCGAA
GTGATACAATCTAACCCGTCCGTC -> TGATACAATCTAACCCGTCCGTCT
CGGAGGCCGAAAGCATTATCAGTC -> GGAGGCCGAAAGCATTATCAGTCT
ATGGGTTGTCCACTACCTTAGTGG -> TGGGTTGTCCACTACCTTAGTGGC
AAAATACCAGTCAACCAGATTCGC -> AAATACCAGTCAACCAGATTCGCC
GATCCAGATTACGAAGTTATCCGC -> ATCCAGATTACGAAGTTATCCGCG
GTCGCCGTTTTCAACTTGTCAGCA -> TCGCCGTTTTCAACTTGTCAGCAA
CGCATAGGCCGAAGGGCCGCGAAC -> GCATAGGCCGAAGGGCCGCGAACA
AGAAGTGACTGACACGGTGCTGTG -> GAAGTGACTGACACGGTGCTGTGT
GATCCCATTTGGAATCCATCCAAT -> ATCCCATTTGGAATCCATCCAATA
TTTGATACAGTCTAGGGTGACGTC -> TTGATACAGTCTAGGGTGACGTCG
CCTAAAAAAATACGAGGTATTTTT -> CTAAAAAAATACGAGGTATTTTTT
TCTCGCATGGGGACGATCCAGATT -> CTCGCATGGGGACGATCCAGATTA
TGACAATATAGATAGAGAACACCG -> GACAATATAGATAGAGAACACCGG
CTTGTCAGCAAGTCGGAGGTGTGG -> TTGTCAGCAAGTCGGAGGTGTGGC
CTCTCGTAAGTTTTACATTCGATG -> TCTCGTAAGTTTTACATTCGATGG
GAAGGGCCGCGAACACTATTCTTT -> AAGGGCCGCGAACACTATTCTTTA
GCGCCTAAAAAAATACGAGGTATT -> CGCCTAAAAAAATACGAGGTATTT
AAGGATAACAGAGCGCCTAAAAAA -> AGGATAACAGAGCGCCTAAAAAAA
ATTTTTTCTCGTAGTTCTGCGTCA -> TTTTTTCTCGTAGTTCTGCGTCAC
CCGCAACTTTCTCACCGGAGACAC -> CGCAACTTTCTCACCGGAGACACG
ACGATATCAATCACTGCATGTATC -> CGATATCAATCACTGCATGTATCC
ATCGACGAAGGCTTTAGATACACG -> TCGACGAAGGCTTTAGATACACGT
CGCTGGAGACATCAACTGGACAGA -> GCTGGAGACATCAACTGGACAGAA
TCGCCTGGGCTGGTCAAAAGATCA -> CGCCTGGGCTGGTCAAAAGATCAC
TAGATAGAGAACACCGGGAATGAT -> AGATAGAGAACACCGGGAATGATC
ACATCGTGGTGTATGCCATCATCT -> CATCGTGGTGTATGCCATCATCTA
GATAGAGAACACCGGGAATGATCA -> ATAGAGAACACCGGGAATGATCAA
CCGGTGCTTAACACACGGAGGCCG -> CGGTGCTTAACACACGGAGGCCGA
TCGTCGCAACGATTCGATCAGATC -> CGTCGCAACGATTCGATCAGATCC
CAAGGATAACAGAGCGCCTAAAAA -> AAGGATAACAGAGCGCCTAAAAAA
AGATCCCATTTGGAATCCATCCAA -> GATCCCATTTGGAATCCATCCAAT
ATAGATAGAGAACACCGGGAATGA -> TAGATAGAGAACACCGGGAATGAT
ATCTACCTACAAAAATACCAGTCA -> TCTACCTACAAAAATACCAGTCAA
CCACCACCCATCGTGATAGTCACT -> CACCACCCATCGTGATAGTCACTG
TAGCCCATCCGGTCCCCACATCGT -> AGCCCATCCGGTCCCCACATCGTG
GACGTCGCGATTAATGGATCGTTT -> ACGTCGCGATTAATGGATCGTTTC
CGATTCGATCAGATCCCATTTGGA -> GATTCGATCAGATCCCATTTGGAA
CTATAATAACTGCGGTGTGCTCGC -> TATAATAACTGCGGTGTGCTCGCG
AGTGACTGACACGGTGCTGTGTTG -> GTGACTGACACGGTGCTGTGTTGT
TTTCTTGGCACCACCACCCATCGT -> TTCTTGGCACCACCACCCATCGTG
ATGGACGCTGCTCTTGCCAGGCCC -> TGGACGCTGCTCTTGCCAGGCCCA
AATGACCTTATCTATTCCAGCTTT -> ATGACCTTATCTATTCCAGCTTTC
GTCTAGGGTGACGTCGCGATTAAT -> TCTAGGGTGACGTCGCGATTAATG
GTAGCGTGACTACTCGATACCCCT -> TAGCGTGACTACTCGATACCCCTG
AACAAAAAGTGCGGTCGCCGTTTT -> ACAAAAAGTGCGGTCGCCGTTTTC
CGTAAGGACGTGGATAAACGGGCA -> GTAAGGACGTGGATAAACGGGCAC
AGTATTTTTGAGACCGAAACCCCT -> GTATTTTTGAGACCGAAACCCCTG
ACGCCTCGCGCACCAGTACTTGGT -> CGCCTCGCGCACCAGTACTTGGTT
TTCTCACCGGAGACACGTAATCAC -> TCTCACCGGAGACACGTAATCACG
TATCAATCACTGCATGTATCCATC -> ATCAATCACTGCATGTATCCATCG
AGATAGAGAACACCGGGAATGATC -> GATAGAGAACACCGGGAATGATCA
CATCATCTATGTGATACAATCTAA -> ATCATCTATGTGATACAATCTAAC
ATTTGGAATCCATCCAATAAAACT -> TTTGGAATCCATCCAATAAAACTC
CCGATAAGACACGGTAACCATATA -> CGATAAGACACGGTAACCATATAT
ACCACCACCCATCGTGATAGTCAC -> CCACCACCCATCGTGATAGTCACT
GACAATATAGATAGAGAACACCGG -> ACAATATAGATAGAGAACACCGGG
CCCTTCATCTCTGCCTAATGACCT -> CCTTCATCTCTGCCTAATGACCTT
GTAACCATATATGTAGCTAGTGTC -> TAACCATATATGTAGCTAGTGTCG
GAGGCCCGTCCCTCGTAGTCCCCC -> AGGCCCGTCCCTCGTAGTCCCCCA
TGCCTTGACTTTGCCTATAATAAC -> GCCTTGACTTTGCCTATAATAACT
CTTGGCACCACCACCCATCGTGAT -> TTGGCACCACCACCCATCGTGATA
TATCTATTCCAGCTTTCTTCGAAT -> ATCTATTCCAGCTTTCTTCGAATG
CGCCGTTTTCAACTTGTCAGCAAG -> GCCGTTTTCAACTTGTCAGCAAGT
GTGCTCGCGAACGCCTCGCGCACC -> TGCTCGCGAACGCCTCGCGCACCA
TTTCACTAGTCAATTTGCACTACG -> TTCACTAGTCAATTTGCACTACGC
TACAATCTAACCCGTCCGTCTCTT -> ACAATCTAACCCGTCCGTCTCTTT
TCCGCGGGGCAATCCTCTGACAAT -> CCGCGGGGCAATCCTCTGACAATA
TGCGGTGTGCTCGCGAACGCCTCG -> GCGGTGTGCTCGCGAACGCCTCGC
CTATGTGATACAATCTAACCCGTC -> TATGTGATACAATCTAACCCGTCC
CGGTGCTGTGTTGTTGTTGGTCAT -> GGTGCTGTGTTGTTGTTGGTCATA
GTCCCCACATCGTGGTGTATGCCA -> TCCCCACATCGTGGTGTATGCCAT
TCGACGAAGGCTTTAGATACACGT -> CGACGAAGGCTTTAGATACACGTC
TGGGGAGATGTACCTTGACACCGC -> GGGGAGATGTACCTTGACACCGCA
TTCGATCAGATCCCATTTGGAATC -> TCGATCAGATCCCATTTGGAATCC
GGGTTCTTCTGTCCGCGACATGGG -> GGTTCTTCTGTCCGCGACATGGGA
CCGTCCGTCTCTTTCTTGGCACCA -> CGTCCGTCTCTTTCTTGGCACCAC
TTGGTTTGATACAGTCTAGGGTGA -> TGGTTTGATACAGTCTAGGGTGAC
GGAATCCATCCAATAAAACTCGGA -> GAATCCATCCAATAAAACTCGGAG
AAAATACGAGGTATTTTTTCTCGT -> AAATACGAGGTATTTTTTCTCGTA
TCTGTCCGCGACATGGGAGGCCCG -> CTGTCCGCGACATGGGAGGCCCGT
AGCGCTGGAGACATCAACTGGACA -> GCGCTGGAGACATCAACTGGACAG
ATTGGATTGGGAACCGCAATAACA -> TTGGATTGGGAACCGCAATAACAA
TATCAGTCTTTGGCAGCCTCTTTA -> ATCAGTCTTTGGCAGCCTCTTTAG
CAGTCTAGGGTGACGTCGCGATTA -> AGTCTAGGGTGACGTCGCGATTAA
ATCGTTTCCTTTAAACAGTGCTAT -> TCGTTTCCTTTAAACAGTGCTATG
AATGATCAAATAAGTTAGTTCCTG -> ATGATCAAATAAGTTAGTTCCTGA
GGAGGTGTGGCAAGGTTTCACTAG -> GAGGTGTGGCAAGGTTTCACTAGT
ACAGAAGTGACTGACACGGTGCTG -> CAGAAGTGACTGACACGGTGCTGT
TCCGACCGGAACGGAAATCTTTTA -> CCGACCGGAACGGAAATCTTTTAG
TCGTAGTCCCCCAGCAGCACCTGC -> CGTAGTCCCCCAGCAGCACCTGCC
TCGGGCTCCAGGTCACCCTCCCCC -> CGGGCTCCAGGTCACCCTCCCCCC
CTCGCGTACGATATCAATCACTGC -> TCGCGTACGATATCAATCACTGCA
TGGGTTGTCCACTACCTTAGTGGC -> GGGTTGTCCACTACCTTAGTGGCT
ACCGGAGACACGTAATCACGCATA -> CCGGAGACACGTAATCACGCATAG
CCCCGTAAGGACGTGGATAAACGG -> CCCGTAAGGACGTGGATAAACGGG
TCTTTGGCAGCCTCTTTAGCTGCA -> CTTTGGCAGCCTCTTTAGCTGCAT
CGTAAGTTTTACATTCGATGGACG -> GTAAGTTTTACATTCGATGGACGC
GCGACCTCAACCTGTTACTCCCAT -> CGACCTCAACCTGTTACTCCCATC
GGGCTGGATTCCGACCATCTCGCG -> GGCTGGATTCCGACCATCTCGCGT
TTGGATTGGGAACCGCAATAACAA -> TGGATTGGGAACCGCAATAACAAT
CCAGCAGCACCTGCCTATATTGTC -> CAGCAGCACCTGCCTATATTGTCG
TTCACTAGTCAATTTGCACTACGC -> TCACTAGTCAATTTGCACTACGCC
GCACCACCACCCATCGTGATAGTC -> CACCACCACCCATCGTGATAGTCA
AAAGCATTATCAGTCTTTGGCAGC -> AAGCATTATCAGTCTTTGGCAGCC
GACTACTCGATACCCCTGATACCA -> ACTACTCGATACCCCTGATACCAG
GATCAAATAAGTTAGTTCCTGAGC -> ATCAAATAAGTTAGTTCCTGAGCG
CCCCCGATAAGACACGGTAACCAT -> CCCCGATAAGACACGGTAACCATA
AGAACATCTTTGCCAGACAAGTAA -> GAACATCTTTGCCAGACAAGTAAC
GCATGGGGACGATCCAGATTACGA -> CATGGGGACGATCCAGATTACGAA
TCGAACATGGTCCCTTCATCTCTG -> CGAACATGGTCCCTTCATCTCTGC
TTATCTATTCCAGCTTTCTTCGAA -> TATCTATTCCAGCTTTCTTCGAAT
ATGTATCCATCGCAGAGGGGTTCT -> TGTATCCATCGCAGAGGGGTTCTT
GCCTAATGACCTTATCTATTCCAG -> CCTAATGACCTTATCTATTCCAGC
GCTGCTCTTGCCAGGCCCAATGGG -> CTGCTCTTGCCAGGCCCAATGGGT
TCAATCACTGCATGTATCCATCGC -> CAATCACTGCATGTATCCATCGCA
CGAACATGGTCCCTTCATCTCTGC -> GAACATGGTCCCTTCATCTCTGCC
CAAAAGATCACTATGCCTTGACTT -> AAAAGATCACTATGCCTTGACTTT
TCCCCCGATAAGACACGGTAACCA -> CCCCCGATAAGACACGGTAACCAT
TTCAACTTGTCAGCAAGTCGGAGG -> TCAACTTGTCAGCAAGTCGGAGGT
TTATCCGCGGGGCAATCCTCTGAC -> TATCCGCGGGGCAATCCTCTGACA
CAAGCCCCCGTAAGGACGTGGATA -> AAGCCCCCGTAAGGACGTGGATAA
AGCGTGACTACTCGATACCCCTGA -> GCGTGACTACTCGATACCCCTGAT
TTTTGAGACCGAAACCCCTGATCT -> TTTGAGACCGAAACCCCTGATCTC
AGGCTTTAGATACACGTCTCGAAC -> GGCTTTAGATACACGTCTCGAACA
AGTCGGAGGTGTGGCAAGGTTTCA -> GTCGGAGGTGTGGCAAGGTTTCAC
GGGGAGATGTACCTTGACACCGCA -> GGGAGATGTACCTTGACACCGCAA
GAGGCCGAAAGCATTATCAGTCTT -> AGGCCGAAAGCATTATCAGTCTTT
TCTTTTCGTCTCCGAAAGATTCGT -> CTTTTCGTCTCCGAAAGATTCGTC
AGACCGAAACCCCTGATCTCAAAA -> GACCGAAACCCCTGATCTCAAAAA
TCCCCCCCGGATCACTAGGGGCTG -> CCCCCCCGGATCACTAGGGGCTGG
ATAACAGAGCGCCTAAAAAAATAC -> TAACAGAGCGCCTAAAAAAATACG
CTGCTCTTGCCAGGCCCAATGGGT -> TGCTCTTGCCAGGCCCAATGGGTT
CCGACTATAGGAATCCGTGCTGGA -> CGACTATAGGAATCCGTGCTGGAG
CCAGATTACGAAGTTATCCGCGGG -> CAGATTACGAAGTTATCCGCGGGG
CGCGAACACTATTCTTTAAGGCAT -> GCGAACACTATTCTTTAAGGCATG
AATATATGGGTTGTCCACTACCTT -> ATATATGGGTTGTCCACTACCTTA
CTCTTTCTTGGCACCACCACCCAT -> TCTTTCTTGGCACCACCACCCATC
GAACATCTTTGCCAGACAAGTAAC -> AACATCTTTGCCAGACAAGTAACC
CAGATTCGCCTGGGCTGGTCAAAA -> AGATTCGCCTGGGCTGGTCAAAAG
AGGACGTGGATAAACGGGCACTAG -> GGACGTGGATAAACGGGCACTAGC
CTTCGAATGCTTCATCTACCTACA -> TTCGAATGCTTCATCTACCTACAA
ATTAAGAGGGACCTGCCAACTTCT -> TTAAGAGGGACCTGCCAACTTCTA
TCAAAAGATCACTATGCCTTGACT -> CAAAAGATCACTATGCCTTGACTT
TTCTTCTGTCCGCGACATGGGAGG -> TCTTCTGTCCGCGACATGGGAGGC
CTGCTTTCCGATTGGATTGGGAAC -> TGCTTTCCGATTGGATTGGGAACC
ATATCAATCACTGCATGTATCCAT -> TATCAATCACTGCATGTATCCATC
CCCCACATCGTGGTGTATGCCATC -> CCCACATCGTGGTGTATGCCATCA
GCAAGCCCCCGTAAGGACGTGGAT -> CAAGCCCCCGTAAGGACGTGGATA
CAGGAGAACAAGTTGACCCTTCCT -> AGGAGAACAAGTTGACCCTTCCTG
TGCTGCACCCTAGGTTCAAGGATA -> GCTGCACCCTAGGTTCAAGGATAA
CGTAGCGTGACTACTCGATACCCC -> GTAGCGTGACTACTCGATACCCCT
GGGCAAGCCCCCGTAAGGACGTGG -> GGCAAGCCCCCGTAAGGACGTGGA
GTGACTGACACGGTGCTGTGTTGT -> TGACTGACACGGTGCTGTGTTGTT
AATCTAACCCGTCCGTCTCTTTCT -> ATCTAACCCGTCCGTCTCTTTCTT
CTGCGTCACCGCAATACGGCTGAG -> TGCGTCACCGCAATACGGCTGAGG
GCGTAGCGTGACTACTCGATACCC -> CGTAGCGTGACTACTCGATACCCC
TCACGCATAGGCCGAAGGGCCGCG -> CACGCATAGGCCGAAGGGCCGCGA
AATGCTCAACACTCCTGCAAGGCC -> ATGCTCAACACTCCTGCAAGGCCT
CAGCTTTCTTCGAATGCTTCATCT -> AGCTTTCTTCGAATGCTTCATCTA
AGTCAACCAGATTCGCCTGGGCTG -> GTCAACCAGATTCGCCTGGGCTGG
AGGCCCGTCCCTCGTAGTCCCCCA -> GGCCCGTCCCTCGTAGTCCCCCAG
TTTCTCGTAGTTCTGCGTCACCGC -> TTCTCGTAGTTCTGCGTCACCGCA
CTAGTGTCGCGTAGCGTGACTACT -> TAGTGTCGCGTAGCGTGACTACTC
CTAATGACCTTATCTATTCCAGCT -> TAATGACCTTATCTATTCCAGCTT
CGATGGACGCTGCTCTTGCCAGGC -> GATGGACGCTGCTCTTGCCAGGCC
TCGCGTACGATATCAATCACTGCA -> CGCGTACGATATCAATCACTGCAT
GCTGCACCCTAGGTTCAAGGATAA -> CTGCACCCTAGGTTCAAGGATAAC
CTTTCTCACCGGAGACACGTAATC -> TTTCTCACCGGAGACACGTAATCA
CGTTTCCTTTAAACAGTGCTATGG -> GTTTCCTTTAAACAGTGCTATGGG
GTCCGCGACATGGGAGGCCCGTCC -> TCCGCGACATGGGAGGCCCGTCCC
TCTTTAGCTGCATATAATCGACGA -> CTTTAGCTGCATATAATCGACGAA
CAATATATGGGTTGTCCACTACCT -> AATATATGGGTTGTCCACTACCTT
AGGGGTTCTTCTGTCCGCGACATG -> GGGGTTCTTCTGTCCGCGACATGG
GACACGGTGCTGTGTTGTTGTTGG -> ACACGGTGCTGTGTTGTTGTTGGT
GCGCTGGAGACATCAACTGGACAG -> CGCTGGAGACATCAACTGGACAGA
CCAGGTCACCCTCCCCCCCGGATC -> CAGGTCACCCTCCCCCCCGGATCA
GGTCCCTTCATCTCTGCCTAATGA -> GTCCCTTCATCTCTGCCTAATGAC
AGAGGGACCTGCCAACTTCTACGA -> GAGGGACCTGCCAACTTCTACGAT
TTAATGGATCGTTTCCTTTAAACA -> TAATGGATCGTTTCCTTTAAACAG
ATGTACCTTGACACCGCAACTTTC -> TGTACCTTGACACCGCAACTTTCT
GATCACTAGGGGCTGGATTCCGAC -> ATCACTAGGGGCTGGATTCCGACC
GGTGCTGTGTTGTTGTTGGTCATA -> GTGCTGTGTTGTTGTTGGTCATAG
GATAACAGAGCGCCTAAAAAAATA -> ATAACAGAGCGCCTAAAAAAATAC
TACCCCTGATACCAGCGCATCATT -> ACCCCTGATACCAGCGCATCATTT
TGATCTCAAAAAGAACATCTTTGC -> GATCTCAAAAAGAACATCTTTGCC
GCCCTGCTTTCCGATTGGATTGGG -> CCCTGCTTTCCGATTGGATTGGGA
GTGGCTCCGACCGGAACGGAAATC -> TGGCTCCGACCGGAACGGAAATCT
AAACGGGCACTAGCCCATCCGGTC -> AACGGGCACTAGCCCATCCGGTCC
TGCCATCATCTATGTGATACAATC -> GCCATCATCTATGTGATACAATCT
CTGCCAACTTCTACGATCTGGACC -> TGCCAACTTCTACGATCTGGACCA
TGGGCTGGTCAAAAGATCACTATG -> GGGCTGGTCAAAAGATCACTATGC
CGTCTCCGAAAGATTCGTCCGACT -> GTCTCCGAAAGATTCGTCCGACTA
TCAACCAGATTCGCCTGGGCTGGT -> CAACCAGATTCGCCTGGGCTGGTC
ACCGCAACTTTCTCACCGGAGACA -> CCGCAACTTTCTCACCGGAGACAC
TGACACCGCAACTTTCTCACCGGA -> GACACCGCAACTTTCTCACCGGAG
GGCCGAAGGGCCGCGAACACTATT -> GCCGAAGGGCCGCGAACACTATTC
GGTGTCCCCCGATAAGACACGGTA -> GTGTCCCCCGATAAGACACGGTAA
ATATTGTCGTCGCAACGATTCGAT -> TATTGTCGTCGCAACGATTCGATC
ATAGTATTTTTGAGACCGAAACCC -> TAGTATTTTTGAGACCGAAACCCC
CAAAAAGAACATCTTTGCCAGACA -> AAAAAGAACATCTTTGCCAGACAA
ACGTGGATAAACGGGCACTAGCCC -> CGTGGATAAACGGGCACTAGCCCA
CCGTGCTGGAGGGGCAAGCCCCCG -> CGTGCTGGAGGGGCAAGCCCCCGT
TTTGAGACCGAAACCCCTGATCTC -> TTGAGACCGAAACCCCTGATCTCA
GCTATGGGGAATGCTCAACACTCC -> CTATGGGGAATGCTCAACACTCCT
ACACTATTCTTTAAGGCATGCTCT -> CACTATTCTTTAAGGCATGCTCTC
CAATATAGATAGAGAACACCGGGA -> AATATAGATAGAGAACACCGGGAA
ACCCGAAATCGAGCGCTGGAGACA -> CCCGAAATCGAGCGCTGGAGACAT
CCGCGACATGGGAGGCCCGTCCCT -> CGCGACATGGGAGGCCCGTCCCTC
GTCCGTCTCTTTCTTGGCACCACC -> TCCGTCTCTTTCTTGGCACCACCA
TCTAACCCGTCCGTCTCTTTCTTG -> CTAACCCGTCCGTCTCTTTCTTGG
CGTGACTACTCGATACCCCTGATA -> GTGACTACTCGATACCCCTGATAC
GACTTTGCCTATAATAACTGCGGT -> ACTTTGCCTATAATAACTGCGGTG
GAGACCGAAACCCCTGATCTCAAA -> AGACCGAAACCCCTGATCTCAAAA
ACCTACAAAAATACCAGTCAACCA -> CCTACAAAAATACCAGTCAACCAG
TGCATGTATCCATCGCAGAGGGGT -> GCATGTATCCATCGCAGAGGGGTT
TGATACAGTCTAGGGTGACGTCGC -> GATACAGTCTAGGGTGACGTCGCG
CTACCTACAAAAATACCAGTCAAC -> TACCTACAAAAATACCAGTCAACC
ATAGGAATCCGTGCTGGAGGGGCA -> TAGGAATCCGTGCTGGAGGGGCAA
GACAACAAAAAGTGCGGTCGCCGT -> ACAACAAAAAGTGCGGTCGCCGTT
GTAGGGCCGGTGCTTAACACACGG -> TAGGGCCGGTGCTTAACACACGGA
TCGTGATAGTCACTGGGGAGATGT -> CGTGATAGTCACTGGGGAGATGTA
CCTCGCGCACCAGTACTTGGTTTG -> CTCGCGCACCAGTACTTGGTTTGA
CTTTAAACAGTGCTATGGGGAATG -> TTTAAACAGTGCTATGGGGAATGC
TTCGGGCTCCAGGTCACCCTCCCC -> TCGGGCTCCAGGTCACCCTCCCCC
CTCTTATTAAGAGGGACCTGCCAA -> TCTTATTAAGAGGGACCTGCCAAC
GTAAGGACGTGGATAAACGGGCAC -> TAAGGACGTGGATAAACGGGCACT
TAGCGTGACTACTCGATACCCCTG -> AGCGTGACTACTCGATACCCCTGA
ACTACGCCCTGCTTTCCGATTGGA -> CTACGCCCTGCTTTCCGATTGGAT
CCCCCGTAAGGACGTGGATAAACG -> CCCCGTAAGGACGTGGATAAACGG
ACAGTCTAGGGTGACGTCGCGATT -> CAGTCTAGGGTGACGTCGCGATTA
GGCCCAATGGGTTCGGGCTCCAGG -> GCCCAATGGGTTCGGGCTCCAGGT
ATCAATCACTGCATGTATCCATCG -> TCAATCACTGCATGTATCCATCGC
GAATCCATCCAATAAAACTCGGAG -> AATCCATCCAATAAAACTCGGAGC
ATGCTCTCGTAAGTTTTACATTCG -> TGCTCTCGTAAGTTTTACATTCGA
CGTCACCGCAATACGGCTGAGGTT -> GTCACCGCAATACGGCTGAGGTTC
GGGCTCCAGGTCACCCTCCCCCCC -> GGCTCCAGGTCACCCTCCCCCCCG
GCGAACACTATTCTTTAAGGCATG -> CGAACACTATTCTTTAAGGCATGC
TACGATATCAATCACTGCATGTAT -> ACGATATCAATCACTGCATGTATC
CGTGGATAAACGGGCACTAGCCCA -> GTGGATAAACGGGCACTAGCCCAT
ACGATCCAGATTACGAAGTTATCC -> CGATCCAGATTACGAAGTTATCCG
CCTCTTATTAAGAGGGACCTGCCA -> CTCTTATTAAGAGGGACCTGCCAA
ACGTCGCGATTAATGGATCGTTTC -> CGTCGCGATTAATGGATCGTTTCC
TAGTAGGGCCGGTGCTTAACACAC -> AGTAGGGCCGGTGCTTAACACACG
ATGACCTTATCTATTCCAGCTTTC -> TGACCTTATCTATTCCAGCTTTCT
TCATTTGGCCCTCTTATTAAGAGG -> CATTTGGCCCTCTTATTAAGAGGG
TGGCAAGGTTTCACTAGTCAATTT -> GGCAAGGTTTCACTAGTCAATTTG
AACAAGTTGACCCTTCCTGCTGCA -> ACAAGTTGACCCTTCCTGCTGCAC
GCGATTAATGGATCGTTTCCTTTA -> CGATTAATGGATCGTTTCCTTTAA
CAGCCTCTTTAGCTGCATATAATC -> AGCCTCTTTAGCTGCATATAATCG
GATTCGTCCGACTATAGGAATCCG -> ATTCGTCCGACTATAGGAATCCGT
AAACCCCTGATCTCAAAAAGAACA -> AACCCCTGATCTCAAAAAGAACAT
GGTCACCCTCCCCCCCGGATCACT -> GTCACCCTCCCCCCCGGATCACTA
AGGTGTGGCAAGGTTTCACTAGTC -> GGTGTGGCAAGGTTTCACTAGTCA
GCCCATCCGGTCCCCACATCGTGG -> CCCATCCGGTCCCCACATCGTGGT
CGATTGGATTGGGAACCGCAATAA -> GATTGGATTGGGAACCGCAATAAC
CACCAGTACTTGGTTTGATACAGT -> ACCAGTACTTGGTTTGATACAGTC
CGACTATAGGAATCCGTGCTGGAG -> GACTATAGGAATCCGTGCTGGAGG
ATCGCAGGAGAACAAGTTGACCCT -> TCGCAGGAGAACAAGTTGACCCTT
GGCAAGCCCCCGTAAGGACGTGGA -> GCAAGCCCCCGTAAGGACGTGGAT
CCCGTAAGGACGTGGATAAACGGG -> CCGTAAGGACGTGGATAAACGGGC
ACCCGTCCGTCTCTTTCTTGGCAC -> CCCGTCCGTCTCTTTCTTGGCACC
GAACGCCTCGCGCACCAGTACTTG -> AACGCCTCGCGCACCAGTACTTGG
CCACATCGTGGTGTATGCCATCAT -> CACATCGTGGTGTATGCCATCATC
CGCGCACCAGTACTTGGTTTGATA -> GCGCACCAGTACTTGGTTTGATAC
ACGGCTGAGGTTCTCTTTTCGTCT -> CGGCTGAGGTTCTCTTTTCGTCTC
ATACCAGCGCATCATTTGGCCCTC -> TACCAGCGCATCATTTGGCCCTCT
TACTTGGTTTGATACAGTCTAGGG -> ACTTGGTTTGATACAGTCTAGGGT
GAATGCTCAACACTCCTGCAAGGC -> AATGCTCAACACTCCTGCAAGGCC
GAGGTTCTCTTTTCGTCTCCGAAA -> AGGTTCTCTTTTCGTCTCCGAAAG
AGTGCTATGGGGAATGCTCAACAC -> GTGCTATGGGGAATGCTCAACACT
TCCATCGCAGAGGGGTTCTTCTGT -> CCATCGCAGAGGGGTTCTTCTGTC
TGGAATCCATCCAATAAAACTCGG -> GGAATCCATCCAATAAAACTCGGA
CTGATCTCAAAAAGAACATCTTTG -> TGATCTCAAAAAGAACATCTTTGC
CTGCCTAATGACCTTATCTATTCC -> TGCCTAATGACCTTATCTATTCCA
TTGCCAGACAAGTAACCTAGTAGG -> TGCCAGACAAGTAACCTAGTAGGG
AACACCGGGAATGATCAAATAAGT -> ACACCGGGAATGATCAAATAAGTT
TTTTTGAGACCGAAACCCCTGATC -> TTTTGAGACCGAAACCCCTGATCT
TATATTGTCGTCGCAACGATTCGA -> ATATTGTCGTCGCAACGATTCGAT
CATCTTTGCCAGACAAGTAACCTA -> ATCTTTGCCAGACAAGTAACCTAG
GAAAGATTCGTCCGACTATAGGAA -> AAAGATTCGTCCGACTATAGGAAT
TAAAAAAATACGAGGTATTTTTTC -> AAAAAAATACGAGGTATTTTTTCT
CTCTTGCCAGGCCCAATGGGTTCG -> TCTTGCCAGGCCCAATGGGTTCGG
GTTCGGGCTCCAGGTCACCCTCCC -> TTCGGGCTCCAGGTCACCCTCCCC
CTGGACCATCGCAGGAGAACAAGT -> TGGACCATCGCAGGAGAACAAGTT
CGCGACATGGGAGGCCCGTCCCTC -> GCGACATGGGAGGCCCGTCCCTCG
CGATATCAATCACTGCATGTATCC -> GATATCAATCACTGCATGTATCCA
CCCTGATACCAGCGCATCATTTGG -> CCTGATACCAGCGCATCATTTGGC
AATCCTCTGACAATATAGATAGAG -> ATCCTCTGACAATATAGATAGAGA
AATCTTTTAGGGGGACAACAAAAA -> ATCTTTTAGGGGGACAACAAAAAG
CGGTAACCATATATGTAGCTAGTG -> GGTAACCATATATGTAGCTAGTGT
CAGACAAGTAACCTAGTAGGGCCG -> AGACAAGTAACCTAGTAGGGCCGG
AGTGCGGTCGCCGTTTTCAACTTG -> GTGCGGTCGCCGTTTTCAACTTGT
CCTAGGTTCAAGGATAACAGAGCG -> CTAGGTTCAAGGATAACAGAGCGC
TCCGTCTCTTTCTTGGCACCACCA -> CCGTCTCTTTCTTGGCACCACCAC
TACCTTGACACCGCAACTTTCTCA -> ACCTTGACACCGCAACTTTCTCAC
TGACTACTCGATACCCCTGATACC -> GACTACTCGATACCCCTGATACCA
GATTACGAAGTTATCCGCGGGGCA -> ATTACGAAGTTATCCGCGGGGCAA
GCATATAATCGACGAAGGCTTTAG -> CATATAATCGACGAAGGCTTTAGA
GCGGGGCAATCCTCTGACAATATA -> CGGGGCAATCCTCTGACAATATAG
TCGAATGCTTCATCTACCTACAAA -> CGAATGCTTCATCTACCTACAAAA
CACCGCAATACGGCTGAGGTTCTC -> ACCGCAATACGGCTGAGGTTCTCT
TATGGGTTGTCCACTACCTTAGTG -> ATGGGTTGTCCACTACCTTAGTGG
AGATGTACCTTGACACCGCAACTT -> GATGTACCTTGACACCGCAACTTT
CAATGGGTTCGGGCTCCAGGTCAC -> AATGGGTTCGGGCTCCAGGTCACC
CACTCCTGCAAGGCCTGGTGTCCC -> ACTCCTGCAAGGCCTGGTGTCCCC
CCCTCGTAGTCCCCCAGCAGCACC -> CCTCGTAGTCCCCCAGCAGCACCT
GGCTTTAGATACACGTCTCGAACA -> GCTTTAGATACACGTCTCGAACAT
GTTCTCTTTTCGTCTCCGAAAGAT -> TTCTCTTTTCGTCTCCGAAAGATT
ATTCGATGGACGCTGCTCTTGCCA -> TTCGATGGACGCTGCTCTTGCCAG
GGGAGGCCCGTCCCTCGTAGTCCC -> GGAGGCCCGTCCCTCGTAGTCCCC
CACTAGCCCATCCGGTCCCCACAT -> ACTAGCCCATCCGGTCCCCACATC
CAACACTCCTGCAAGGCCTGGTGT -> AACACTCCTGCAAGGCCTGGTGTC
CCTTATCTATTCCAGCTTTCTTCG -> CTTATCTATTCCAGCTTTCTTCGA
AATAAGTTAGTTCCTGAGCGACCT -> ATAAGTTAGTTCCTGAGCGACCTC
GTGGTGTATGCCATCATCTATGTG -> TGGTGTATGCCATCATCTATGTGA
ACACCGGGAATGATCAAATAAGTT -> CACCGGGAATGATCAAATAAGTTA
TGCGTCACCGCAATACGGCTGAGG -> GCGTCACCGCAATACGGCTGAGGT
GGAGGCCGAAAGCATTATCAGTCT -> GAGGCCGAAAGCATTATCAGTCTT
TCAACCTGTTACTCCCATCAATAT -> CAACCTGTTACTCCCATCAATATA
TTTGGAATCCATCCAATAAAACTC -> TTGGAATCCATCCAATAAAACTCG
AAGGCATGCTCTCGTAAGTTTTAC -> AGGCATGCTCTCGTAAGTTTTACA
AACTTTCTCACCGGAGACACGTAA -> ACTTTCTCACCGGAGACACGTAAT
CATTATCAGTCTTTGGCAGCCTCT -> ATTATCAGTCTTTGGCAGCCTCTT
GACGTGGATAAACGGGCACTAGCC -> ACGTGGATAAACGGGCACTAGCCC
CATCATTTGGCCCTCTTATTAAGA -> ATCATTTGGCCCTCTTATTAAGAG
TTCGAATGCTTCATCTACCTACAA -> TCGAATGCTTCATCTACCTACAAA
GGAGCTCTCGCATGGGGACGATCC -> GAGCTCTCGCATGGGGACGATCCA
CACCTGCCTATATTGTCGTCGCAA -> ACCTGCCTATATTGTCGTCGCAAC
AATCCATCCAATAAAACTCGGAGC -> ATCCATCCAATAAAACTCGGAGCT
GGGGCTGGATTCCGACCATCTCGC -> GGGCTGGATTCCGACCATCTCGCG
CTAAAAAAATACGAGGTATTTTTT -> TAAAAAAATACGAGGTATTTTTTC
TGGACCATCGCAGGAGAACAAGTT -> GGACCATCGCAGGAGAACAAGTTG
AGTTCTGCGTCACCGCAATACGGC -> GTTCTGCGTCACCGCAATACGGCT
AGTAACCTAGTAGGGCCGGTGCTT -> GTAACCTAGTAGGGCCGGTGCTTA
ATAATCGACGAAGGCTTTAGATAC -> TAATCGACGAAGGCTTTAGATACA
CATGGGGACGATCCAGATTACGAA -> ATGGGGACGATCCAGATTACGAAG
CCTGGTGTCCCCCGATAAGACACG -> CTGGTGTCCCCCGATAAGACACGG
CGAGGTATTTTTTCTCGTAGTTCT -> GAGGTATTTTTTCTCGTAGTTCTG
CGATAAGACACGGTAACCATATAT -> GATAAGACACGGTAACCATATATG
TCCACTACCTTAGTGGCTCCGACC -> CCACTACCTTAGTGGCTCCGACCG
TTCGATGGACGCTGCTCTTGCCAG -> TCGATGGACGCTGCTCTTGCCAGG
GATCTCAAAAAGAACATCTTTGCC -> ATCTCAAAAAGAACATCTTTGCCA
TCGGAGGTGTGGCAAGGTTTCACT -> CGGAGGTGTGGCAAGGTTTCACTA
TTCTCGTAGTTCTGCGTCACCGCA -> TCTCGTAGTTCTGCGTCACCGCAA
ATTCCAGCTTTCTTCGAATGCTTC -> TTCCAGCTTTCTTCGAATGCTTCA
GAGGGACCTGCCAACTTCTACGAT -> AGGGACCTGCCAACTTCTACGATC
TGGCTCCGACCGGAACGGAAATCT -> GGCTCCGACCGGAACGGAAATCTT
CGGGCTCCAGGTCACCCTCCCCCC -> GGGCTCCAGGTCACCCTCCCCCCC
TCTTGCCAGGCCCAATGGGTTCGG -> CTTGCCAGGCCCAATGGGTTCGGG
GTCGCGTAGCGTGACTACTCGATA -> TCGCGTAGCGTGACTACTCGATAC
CCCTAGGTTCAAGGATAACAGAGC -> CCTAGGTTCAAGGATAACAGAGCG
ATATATGTAGCTAGTGTCGCGTAG -> TATATGTAGCTAGTGTCGCGTAGC
CGGTCCCCACATCGTGGTGTATGC -> GGTCCCCACATCGTGGTGTATGCC
CCCGTCCGTCTCTTTCTTGGCACC -> CCGTCCGTCTCTTTCTTGGCACCA
CCGGTCCCCACATCGTGGTGTATG -> CGGTCCCCACATCGTGGTGTATGC
GGGGACAACAAAAAGTGCGGTCGC -> GGGACAACAAAAAGTGCGGTCGCC
GCGACATGGGAGGCCCGTCCCTCG -> CGACATGGGAGGCCCGTCCCTCGT
CACTGCATGTATCCATCGCAGAGG -> ACTGCATGTATCCATCGCAGAGGG
CTTTCTTCGAATGCTTCATCTACC -> TTTCTTCGAATGCTTCATCTACCT
CTGCAAGGCCTGGTGTCCCCCGAT -> TGCAAGGCCTGGTGTCCCCCGATA
AAGATTCGTCCGACTATAGGAATC -> AGATTCGTCCGACTATAGGAATCC
TGCCAACTTCTACGATCTGGACCA -> GCCAACTTCTACGATCTGGACCAT
AACCATATATGTAGCTAGTGTCGC -> ACCATATATGTAGCTAGTGTCGCG
GCAATCCTCTGACAATATAGATAG -> CAATCCTCTGACAATATAGATAGA
CACTACCTTAGTGGCTCCGACCGG -> ACTACCTTAGTGGCTCCGACCGGA
TACGCCCTGCTTTCCGATTGGATT -> ACGCCCTGCTTTCCGATTGGATTG
GATAGTCACTGGGGAGATGTACCT -> ATAGTCACTGGGGAGATGTACCTT
CCTGTTACTCCCATCAATATATGG -> CTGTTACTCCCATCAATATATGGG
ATAATAACTGCGGTGTGCTCGCGA -> TAATAACTGCGGTGTGCTCGCGAA
AAGTAACCTAGTAGGGCCGGTGCT -> AGTAACCTAGTAGGGCCGGTGCTT
ACCAGTCAACCAGATTCGCCTGGG -> CCAGTCAACCAGATTCGCCTGGGC
ATGGGAGGCCCGTCCCTCGTAGTC -> TGGGAGGCCCGTCCCTCGTAGTCC
GTGTATGCCATCATCTATGTGATA -> TGTATGCCATCATCTATGTGATAC
AGCTTTCTTCGAATGCTTCATCTA -> GCTTTCTTCGAATGCTTCATCTAC
ATTCGATCAGATCCCATTTGGAAT -> TTCGATCAGATCCCATTTGGAATC
GTTCTGCGTCACCGCAATACGGCT -> TTCTGCGTCACCGCAATACGGCTG
CCGATTGGATTGGGAACCGCAATA -> CGATTGGATTGGGAACCGCAATAA
GGATCACTAGGGGCTGGATTCCGA -> GATCACTAGGGGCTGGATTCCGAC
AGCTCTCGCATGGGGACGATCCAG -> GCTCTCGCATGGGGACGATCCAGA
GAGACATCAACTGGACAGAAGTGA -> AGACATCAACTGGACAGAAGTGAC
CCCCCAGCAGCACCTGCCTATATT -> CCCCAGCAGCACCTGCCTATATTG
GCGGTGTGCTCGCGAACGCCTCGC -> CGGTGTGCTCGCGAACGCCTCGCG
TGTCCGCGACATGGGAGGCCCGTC -> GTCCGCGACATGGGAGGCCCGTCC
TAGGGTGACGTCGCGATTAATGGA -> AGGGTGACGTCGCGATTAATGGAT
CGCGTAGCGTGACTACTCGATACC -> GCGTAGCGTGACTACTCGATACCC
AGTTCCTGAGCGACCTCAACCTGT -> GTTCCTGAGCGACCTCAACCTGTT
ATAAACGGGCACTAGCCCATCCGG -> TAAACGGGCACTAGCCCATCCGGT
TCGCGCACCAGTACTTGGTTTGAT -> CGCGCACCAGTACTTGGTTTGATA
TGCCAGACAAGTAACCTAGTAGGG -> GCCAGACAAGTAACCTAGTAGGGC
CCGAAAGCATTATCAGTCTTTGGC -> CGAAAGCATTATCAGTCTTTGGCA
AAGCATTATCAGTCTTTGGCAGCC -> AGCATTATCAGTCTTTGGCAGCCT
GCTAGTGTCGCGTAGCGTGACTAC -> CTAGTGTCGCGTAGCGTGACTACT
GCCTAAAAAAATACGAGGTATTTT -> CCTAAAAAAATACGAGGTATTTTT
AGGTATTTTTTCTCGTAGTTCTGC -> GGTATTTTTTCTCGTAGTTCTGCG
ATTATCAGTCTTTGGCAGCCTCTT -> TTATCAGTCTTTGGCAGCCTCTTT
GGAATGCTCAACACTCCTGCAAGG -> GAATGCTCAACACTCCTGCAAGGC
CGTAGTCCCCCAGCAGCACCTGCC -> GTAGTCCCCCAGCAGCACCTGCCT
ACAAGTAACCTAGTAGGGCCGGTG -> CAAGTAACCTAGTAGGGCCGGTGC
GAATGATCAAATAAGTTAGTTCCT -> AATGATCAAATAAGTTAGTTCCTG
AAACTCGGAGCTCTCGCATGGGGA -> AACTCGGAGCTCTCGCATGGGGAC
GAGATGTACCTTGACACCGCAACT -> AGATGTACCTTGACACCGCAACTT
CGTCTCTTTCTTGGCACCACCACC -> GTCTCTTTCTTGGCACCACCACCC
ACTTTGCCTATAATAACTGCGGTG -> CTTTGCCTATAATAACTGCGGTGT
AGTGTCGCGTAGCGTGACTACTCG -> GTGTCGCGTAGCGTGACTACTCGA
ACGTAATCACGCATAGGCCGAAGG -> CGTAATCACGCATAGGCCGAAGGG
CTTGGTTTGATACAGTCTAGGGTG -> TTGGTTTGATACAGTCTAGGGTGA
CTTAGTGGCTCCGACCGGAACGGA -> TTAGTGGCTCCGACCGGAACGGAA
GTCCCTCGTAGTCCCCCAGCAGCA -> TCCCTCGTAGTCCCCCAGCAGCAC
ATATAGATAGAGAACACCGGGAAT -> TATAGATAGAGAACACCGGGAATG
ATACGGCTGAGGTTCTCTTTTCGT -> TACGGCTGAGGTTCTCTTTTCGTC
TATCCATCGCAGAGGGGTTCTTCT -> ATCCATCGCAGAGGGGTTCTTCTG
TTGTCCACTACCTTAGTGGCTCCG -> TGTCCACTACCTTAGTGGCTCCGA
CATCAATATATGGGTTGTCCACTA -> ATCAATATATGGGTTGTCCACTAC
CTCGCGCACCAGTACTTGGTTTGA -> TCGCGCACCAGTACTTGGTTTGAT
GACCTGCCAACTTCTACGATCTGG -> ACCTGCCAACTTCTACGATCTGGA
TTGCCTATAATAACTGCGGTGTGC -> TGCCTATAATAACTGCGGTGTGCT
GCTCGCGAACGCCTCGCGCACCAG -> CTCGCGAACGCCTCGCGCACCAGT
CAACCTGTTACTCCCATCAATATA -> AACCTGTTACTCCCATCAATATAT
AAATACGAGGTATTTTTTCTCGTA -> AATACGAGGTATTTTTTCTCGTAG
ATTTGCACTACGCCCTGCTTTCCG -> TTTGCACTACGCCCTGCTTTCCGA
ATGGATCGTTTCCTTTAAACAGTG -> TGGATCGTTTCCTTTAAACAGTGC
GCACTACGCCCTGCTTTCCGATTG -> CACTACGCCCTGCTTTCCGATTGG
GGGCACTAGCCCATCCGGTCCCCA -> GGCACTAGCCCATCCGGTCCCCAC
CCTGCCTATATTGTCGTCGCAACG -> CTGCCTATATTGTCGTCGCAACGA
GAGAACACCGGGAATGATCAAATA -> AGAACACCGGGAATGATCAAATAA
TGTTGTTGGTCATAGTATTTTTGA -> GTTGTTGGTCATAGTATTTTTGAG
GATATCAATCACTGCATGTATCCA -> ATATCAATCACTGCATGTATCCAT
GAAACCCCTGATCTCAAAAAGAAC -> AAACCCCTGATCTCAAAAAGAACA
CAATCCTCTGACAATATAGATAGA -> AATCCTCTGACAATATAGATAGAG
AGCCCCCGTAAGGACGTGGATAAA -> GCCCCCGTAAGGACGTGGATAAAC
CTCAAAAAGAACATCTTTGCCAGA -> TCAAAAAGAACATCTTTGCCAGAC
TCCGATTGGATTGGGAACCGCAAT -> CCGATTGGATTGGGAACCGCAATA
ATCTATTCCAGCTTTCTTCGAATG -> TCTATTCCAGCTTTCTTCGAATGC
TAAGACACGGTAACCATATATGTA -> AAGACACGGTAACCATATATGTAG
AAGTCGGAGGTGTGGCAAGGTTTC -> AGTCGGAGGTGTGGCAAGGTTTCA
AGGTTCAAGGATAACAGAGCGCCT -> GGTTCAAGGATAACAGAGCGCCTA
ACGGAGGCCGAAAGCATTATCAGT -> CGGAGGCCGAAAGCATTATCAGTC
TTTGCCTATAATAACTGCGGTGTG -> TTGCCTATAATAACTGCGGTGTGC
TCTACCTACAAAAATACCAGTCAA -> CTACCTACAAAAATACCAGTCAAC
TCATCTCTGCCTAATGACCTTATC -> CATCTCTGCCTAATGACCTTATCT
TCAGATCCCATTTGGAATCCATCC -> CAGATCCCATTTGGAATCCATCCA
TCATCTACCTACAAAAATACCAGT -> CATCTACCTACAAAAATACCAGTC
GAAATCGAGCGCTGGAGACATCAA -> AAATCGAGCGCTGGAGACATCAAC
GCTCTTGCCAGGCCCAATGGGTTC -> CTCTTGCCAGGCCCAATGGGTTCG
CGGCTGAGGTTCTCTTTTCGTCTC -> GGCTGAGGTTCTCTTTTCGTCTCC
TTGTCGTCGCAACGATTCGATCAG -> TGTCGTCGCAACGATTCGATCAGA
AAGGACGTGGATAAACGGGCACTA -> AGGACGTGGATAAACGGGCACTAG
TAACACACGGAGGCCGAAAGCATT -> AACACACGGAGGCCGAAAGCATTA
GTTTGATACAGTCTAGGGTGACGT -> TTTGATACAGTCTAGGGTGACGTC
TGCTCTCGTAAGTTTTACATTCGA -> GCTCTCGTAAGTTTTACATTCGAT
AGACACGTAATCACGCATAGGCCG -> GACACGTAATCACGCATAGGCCGA
CCGTCCCTCGTAGTCCCCCAGCAG -> CGTCCCTCGTAGTCCCCCAGCAGC
GCGCATCATTTGGCCCTCTTATTA -> CGCATCATTTGGCCCTCTTATTAA
TAGATACACGTCTCGAACATGGTC -> AGATACACGTCTCGAACATGGTCC
ATCTGGACCATCGCAGGAGAACAA -> TCTGGACCATCGCAGGAGAACAAG
CGGTGCTTAACACACGGAGGCCGA -> GGTGCTTAACACACGGAGGCCGAA
CTTGACACCGCAACTTTCTCACCG -> TTGACACCGCAACTTTCTCACCGG
ATCTTTGCCAGACAAGTAACCTAG -> TCTTTGCCAGACAAGTAACCTAGT
ATCCGCGGGGCAATCCTCTGACAA -> TCCGCGGGGCAATCCTCTGACAAT
ACGAAGTTATCCGCGGGGCAATCC -> CGAAGTTATCCGCGGGGCAATCCT
AACAGAGCGCCTAAAAAAATACGA -> ACAGAGCGCCTAAAAAAATACGAG
GAGCGCCTAAAAAAATACGAGGTA -> AGCGCCTAAAAAAATACGAGGTAT
ATCAACTGGACAGAAGTGACTGAC -> TCAACTGGACAGAAGTGACTGACA
AGATTACGAAGTTATCCGCGGGGC -> GATTACGAAGTTATCCGCGGGGCA
GGACCATCGCAGGAGAACAAGTTG -> GACCATCGCAGGAGAACAAGTTGA
TGCTCTTGCCAGGCCCAATGGGTT -> GCTCTTGCCAGGCCCAATGGGTTC
TGGTGTCCCCCGATAAGACACGGT -> GGTGTCCCCCGATAAGACACGGTA
GTCCCCCGATAAGACACGGTAACC -> TCCCCCGATAAGACACGGTAACCA
TAAGAGGGACCTGCCAACTTCTAC -> AAGAGGGACCTGCCAACTTCTACG
TTACGAAGTTATCCGCGGGGCAAT -> TACGAAGTTATCCGCGGGGCAATC
CGCAGAGGGGTTCTTCTGTCCGCG -> GCAGAGGGGTTCTTCTGTCCGCGA
GCTCCGACCGGAACGGAAATCTTT -> CTCCGACCGGAACGGAAATCTTTT
AGTTGACCCTTCCTGCTGCACCCT -> GTTGACCCTTCCTGCTGCACCCTA
TTCGCCTGGGCTGGTCAAAAGATC -> TCGCCTGGGCTGGTCAAAAGATCA
TGCCAGGCCCAATGGGTTCGGGCT -> GCCAGGCCCAATGGGTTCGGGCTC
CTCCCATCAATATATGGGTTGTCC -> TCCCATCAATATATGGGTTGTCCA
TATTGTCGTCGCAACGATTCGATC -> ATTGTCGTCGCAACGATTCGATCA
ATCACTATGCCTTGACTTTGCCTA -> TCACTATGCCTTGACTTTGCCTAT
AAAAAGAACATCTTTGCCAGACAA -> AAAAGAACATCTTTGCCAGACAAG
TTGACACCGCAACTTTCTCACCGG -> TGACACCGCAACTTTCTCACCGGA
ACACGGTGCTGTGTTGTTGTTGGT -> CACGGTGCTGTGTTGTTGTTGGTC
AACATCTTTGCCAGACAAGTAACC -> ACATCTTTGCCAGACAAGTAACCT
GTATTTTTTCTCGTAGTTCTGCGT -> TATTTTTTCTCGTAGTTCTGCGTC
GAACAAGTTGACCCTTCCTGCTGC -> AACAAGTTGACCCTTCCTGCTGCA
CCGAAAGATTCGTCCGACTATAGG -> CGAAAGATTCGTCCGACTATAGGA
AGGCATGCTCTCGTAAGTTTTACA -> GGCATGCTCTCGTAAGTTTTACAT
GAGGTATTTTTTCTCGTAGTTCTG -> AGGTATTTTTTCTCGTAGTTCTGC
CATCGCAGAGGGGTTCTTCTGTCC -> ATCGCAGAGGGGTTCTTCTGTCCG
AAATCGAGCGCTGGAGACATCAAC -> AATCGAGCGCTGGAGACATCAACT
TCTGCGTCACCGCAATACGGCTGA -> CTGCGTCACCGCAATACGGCTGAG
TTGGCCCTCTTATTAAGAGGGACC -> TGGCCCTCTTATTAAGAGGGACCT
CCGCAATACGGCTGAGGTTCTCTT -> CGCAATACGGCTGAGGTTCTCTTT
AGCGCATCATTTGGCCCTCTTATT -> GCGCATCATTTGGCCCTCTTATTA
CTTATCTATTCCAGCTTTCTTCGA -> TTATCTATTCCAGCTTTCTTCGAA
GAGGGGTTCTTCTGTCCGCGACAT -> AGGGGTTCTTCTGTCCGCGACATG
GGTCGCCGTTTTCAACTTGTCAGC -> GTCGCCGTTTTCAACTTGTCAGCA
AGGTTCTCTTTTCGTCTCCGAAAG -> GGTTCTCTTTTCGTCTCCGAAAGA
GAGCGACCTCAACCTGTTACTCCC -> AGCGACCTCAACCTGTTACTCCCA
CTCTTTAGCTGCATATAATCGACG -> TCTTTAGCTGCATATAATCGACGA
ATCTCTGCCTAATGACCTTATCTA -> TCTCTGCCTAATGACCTTATCTAT
TCGAGCGCTGGAGACATCAACTGG -> CGAGCGCTGGAGACATCAACTGGA
TCTCGTAGTTCTGCGTCACCGCAA -> CTCGTAGTTCTGCGTCACCGCAAT
CTTTTAGGGGGACAACAAAAAGTG -> TTTTAGGGGGACAACAAAAAGTGC
CAGATTACGAAGTTATCCGCGGGG -> AGATTACGAAGTTATCCGCGGGGC
CTGGAGGGGCAAGCCCCCGTAAGG -> TGGAGGGGCAAGCCCCCGTAAGGA
CTTGACTTTGCCTATAATAACTGC -> TTGACTTTGCCTATAATAACTGCG
CACACGGAGGCCGAAAGCATTATC -> ACACGGAGGCCGAAAGCATTATCA
CGAGCGCTGGAGACATCAACTGGA -> GAGCGCTGGAGACATCAACTGGAC
ACGGTAACCATATATGTAGCTAGT -> CGGTAACCATATATGTAGCTAGTG
GACACGTAATCACGCATAGGCCGA -> ACACGTAATCACGCATAGGCCGAA
GAGGTGTGGCAAGGTTTCACTAGT -> AGGTGTGGCAAGGTTTCACTAGTC
TTAGATACACGTCTCGAACATGGT -> TAGATACACGTCTCGAACATGGTC
GGACAGAAGTGACTGACACGGTGC -> GACAGAAGTGACTGACACGGTGCT
TATAGGAATCCGTGCTGGAGGGGC -> ATAGGAATCCGTGCTGGAGGGGCA
TAAAACTCGGAGCTCTCGCATGGG -> AAAACTCGGAGCTCTCGCATGGGG
CCGGAACGGAAATCTTTTAGGGGG -> CGGAACGGAAATCTTTTAGGGGGA
TATTCCAGCTTTCTTCGAATGCTT -> ATTCCAGCTTTCTTCGAATGCTTC
GGTGTGGCAAGGTTTCACTAGTCA -> GTGTGGCAAGGTTTCACTAGTCAA
TCCCTCGTAGTCCCCCAGCAGCAC -> CCCTCGTAGTCCCCCAGCAGCACC
AGAACACCGGGAATGATCAAATAA -> GAACACCGGGAATGATCAAATAAG
AACTTCTACGATCTGGACCATCGC -> ACTTCTACGATCTGGACCATCGCA
CCCAGCAGCACCTGCCTATATTGT -> CCAGCAGCACCTGCCTATATTGTC
CAAAAATACCAGTCAACCAGATTC -> AAAAATACCAGTCAACCAGATTCG
AACTCGGAGCTCTCGCATGGGGAC -> ACTCGGAGCTCTCGCATGGGGACG
AATACCAGTCAACCAGATTCGCCT -> ATACCAGTCAACCAGATTCGCCTG
CCCCCCGGATCACTAGGGGCTGGA -> CCCCCGGATCACTAGGGGCTGGAT
TGTTGGTCATAGTATTTTTGAGAC -> GTTGGTCATAGTATTTTTGAGACC
ATCACGCATAGGCCGAAGGGCCGC -> TCACGCATAGGCCGAAGGGCCGCG
TCACCGGAGACACGTAATCACGCA -> CACCGGAGACACGTAATCACGCAT
ACAATATAGATAGAGAACACCGGG -> CAATATAGATAGAGAACACCGGGA
TAGTTCTGCGTCACCGCAATACGG -> AGTTCTGCGTCACCGCAATACGGC
GGGGCAAGCCCCCGTAAGGACGTG -> GGGCAAGCCCCCGTAAGGACGTGG
TAGGCCGAAGGGCCGCGAACACTA -> AGGCCGAAGGGCCGCGAACACTAT
ATGTAGCTAGTGTCGCGTAGCGTG -> TGTAGCTAGTGTCGCGTAGCGTGA
GCCAGACAAGTAACCTAGTAGGGC -> CCAGACAAGTAACCTAGTAGGGCC
GCTTCATCTACCTACAAAAATACC -> CTTCATCTACCTACAAAAATACCA
TTTAGCTGCATATAATCGACGAAG -> TTAGCTGCATATAATCGACGAAGG
TTGGAATCCATCCAATAAAACTCG -> TGGAATCCATCCAATAAAACTCGG
AGGGACCTGCCAACTTCTACGATC -> GGGACCTGCCAACTTCTACGATCT
ATGGGGAATGCTCAACACTCCTGC -> TGGGGAATGCTCAACACTCCTGCA
CACTGGGGAGATGTACCTTGACAC -> ACTGGGGAGATGTACCTTGACACC
GCACCAGTACTTGGTTTGATACAG -> CACCAGTACTTGGTTTGATACAGT
TTCTTCGAATGCTTCATCTACCTA -> TCTTCGAATGCTTCATCTACCTAC
AAGTGCGGTCGCCGTTTTCAACTT -> AGTGCGGTCGCCGTTTTCAACTTG
TAACTGCGGTGTGCTCGCGAACGC -> AACTGCGGTGTGCTCGCGAACGCC
CACGGTGCTGTGTTGTTGTTGGTC -> ACGGTGCTGTGTTGTTGTTGGTCA
ACCCCTGATACCAGCGCATCATTT -> CCCCTGATACCAGCGCATCATTTG
GCCGAAGGGCCGCGAACACTATTC -> CCGAAGGGCCGCGAACACTATTCT
TGGGGACGATCCAGATTACGAAGT -> GGGGACGATCCAGATTACGAAGTT
GTATGCCATCATCTATGTGATACA -> TATGCCATCATCTATGTGATACAA
GCAGGAGAACAAGTTGACCCTTCC -> CAGGAGAACAAGTTGACCCTTCCT
AACCAGATTCGCCTGGGCTGGTCA -> ACCAGATTCGCCTGGGCTGGTCAA
AGCAAGTCGGAGGTGTGGCAAGGT -> GCAAGTCGGAGGTGTGGCAAGGTT
ATACGAGGTATTTTTTCTCGTAGT -> TACGAGGTATTTTTTCTCGTAGTT
AATCACTGCATGTATCCATCGCAG -> ATCACTGCATGTATCCATCGCAGA
ACACGGTAACCATATATGTAGCTA -> CACGGTAACCATATATGTAGCTAG
CGAAGGGCCGCGAACACTATTCTT -> GAAGGGCCGCGAACACTATTCTTT
TAGCTGCATATAATCGACGAAGGC -> AGCTGCATATAATCGACGAAGGCT
TCGCGAACGCCTCGCGCACCAGTA -> CGCGAACGCCTCGCGCACCAGTAC
GTGCGGTCGCCGTTTTCAACTTGT -> TGCGGTCGCCGTTTTCAACTTGTC
TGGACGCTGCTCTTGCCAGGCCCA -> GGACGCTGCTCTTGCCAGGCCCAA
GCCGGTGCTTAACACACGGAGGCC -> CCGGTGCTTAACACACGGAGGCCG
CATCCGGTCCCCACATCGTGGTGT -> ATCCGGTCCCCACATCGTGGTGTA
CCCATCCGGTCCCCACATCGTGGT -> CCATCCGGTCCCCACATCGTGGTG
CCGGGAATGATCAAATAAGTTAGT -> CGGGAATGATCAAATAAGTTAGTT
CTAGCCCATCCGGTCCCCACATCG -> TAGCCCATCCGGTCCCCACATCGT
ATACAGTCTAGGGTGACGTCGCGA -> TACAGTCTAGGGTGACGTCGCGAT
TCACTAGTCAATTTGCACTACGCC -> CACTAGTCAATTTGCACTACGCCC
ACTTGTCAGCAAGTCGGAGGTGTG -> CTTGTCAGCAAGTCGGAGGTGTGG
TTTCCGATTGGATTGGGAACCGCA -> TTCCGATTGGATTGGGAACCGCAA
CGGAGGTGTGGCAAGGTTTCACTA -> GGAGGTGTGGCAAGGTTTCACTAG
CCGACCATCTCGCGTACGATATCA -> CGACCATCTCGCGTACGATATCAA
TGTCGTCGCAACGATTCGATCAGA -> GTCGTCGCAACGATTCGATCAGAT
GCATTATCAGTCTTTGGCAGCCTC -> CATTATCAGTCTTTGGCAGCCTCT
AAGGCTTTAGATACACGTCTCGAA -> AGGCTTTAGATACACGTCTCGAAC
CAGTCAACCAGATTCGCCTGGGCT -> AGTCAACCAGATTCGCCTGGGCTG
TAATCACGCATAGGCCGAAGGGCC -> AATCACGCATAGGCCGAAGGGCCG
CATGTATCCATCGCAGAGGGGTTC -> ATGTATCCATCGCAGAGGGGTTCT
CGCTGCTCTTGCCAGGCCCAATGG -> GCTGCTCTTGCCAGGCCCAATGGG
GCCTATAATAACTGCGGTGTGCTC -> CCTATAATAACTGCGGTGTGCTCG
CCCTGATCTCAAAAAGAACATCTT -> CCTGATCTCAAAAAGAACATCTTT
TACCTACAAAAATACCAGTCAACC -> ACCTACAAAAATACCAGTCAACCA
GACGCTGCTCTTGCCAGGCCCAAT -> ACGCTGCTCTTGCCAGGCCCAATG
ACAAGTTGACCCTTCCTGCTGCAC -> CAAGTTGACCCTTCCTGCTGCACC
CTCGTAGTTCTGCGTCACCGCAAT -> TCGTAGTTCTGCGTCACCGCAATA
CTTTCTTGGCACCACCACCCATCG -> TTTCTTGGCACCACCACCCATCGT
TCTTTGCCAGACAAGTAACCTAGT -> CTTTGCCAGACAAGTAACCTAGTA
ATTAATGGATCGTTTCCTTTAAAC -> TTAATGGATCGTTTCCTTTAAACA
AACGGGCACTAGCCCATCCGGTCC -> ACGGGCACTAGCCCATCCGGTCCC
GCGCACCAGTACTTGGTTTGATAC -> CGCACCAGTACTTGGTTTGATACA
ACAGTGCTATGGGGAATGCTCAAC -> CAGTGCTATGGGGAATGCTCAACA
ACTCGATACCCCTGATACCAGCGC -> CTCGATACCCCTGATACCAGCGCA
TGACTTTGCCTATAATAACTGCGG -> GACTTTGCCTATAATAACTGCGGT
GGATAAACGGGCACTAGCCCATCC -> GATAAACGGGCACTAGCCCATCCG
GCACTAGCCCATCCGGTCCCCACA -> CACTAGCCCATCCGGTCCCCACAT
GGCCGGTGCTTAACACACGGAGGC -> GCCGGTGCTTAACACACGGAGGCC
CGATCTGGACCATCGCAGGAGAAC -> GATCTGGACCATCGCAGGAGAACA
GGTGACGTCGCGATTAATGGATCG -> GTGACGTCGCGATTAATGGATCGT
ATCAGATCCCATTTGGAATCCATC -> TCAGATCCCATTTGGAATCCATCC
CGAAGTTATCCGCGGGGCAATCCT -> GAAGTTATCCGCGGGGCAATCCTC
GGGGTTCTTCTGTCCGCGACATGG -> GGGTTCTTCTGTCCGCGACATGGG
ACTATAGGAATCCGTGCTGGAGGG -> CTATAGGAATCCGTGCTGGAGGGG
TCTCTGCCTAATGACCTTATCTAT -> CTCTGCCTAATGACCTTATCTATT
GAGACACGTAATCACGCATAGGCC -> AGACACGTAATCACGCATAGGCCG
CGATCCAGATTACGAAGTTATCCG -> GATCCAGATTACGAAGTTATCCGC
AAGATCACTATGCCTTGACTTTGC -> AGATCACTATGCCTTGACTTTGCC
CAAGTCGGAGGTGTGGCAAGGTTT -> AAGTCGGAGGTGTGGCAAGGTTTC
CGAAGGCTTTAGATACACGTCTCG -> GAAGGCTTTAGATACACGTCTCGA
AGTTAGTTCCTGAGCGACCTCAAC -> GTTAGTTCCTGAGCGACCTCAACC
CAAGGTTTCACTAGTCAATTTGCA -> AAGGTTTCACTAGTCAATTTGCAC
CTAGGGGCTGGATTCCGACCATCT -> TAGGGGCTGGATTCCGACCATCTC
CCTGGGCTGGTCAAAAGATCACTA -> CTGGGCTGGTCAAAAGATCACTAT
CACGGAGGCCGAAAGCATTATCAG -> ACGGAGGCCGAAAGCATTATCAGT
TTTTCTCGTAGTTCTGCGTCACCG -> TTTCTCGTAGTTCTGCGTCACCGC
ACTCCTGCAAGGCCTGGTGTCCCC -> CTCCTGCAAGGCCTGGTGTCCCCC
GTCCCCCAGCAGCACCTGCCTATA -> TCCCCCAGCAGCACCTGCCTATAT
CTGACAATATAGATAGAGAACACC -> TGACAATATAGATAGAGAACACCG
ATAGGCCGAAGGGCCGCGAACACT -> TAGGCCGAAGGGCCGCGAACACTA
GGCCTGGTGTCCCCCGATAAGACA -> GCCTGGTGTCCCCCGATAAGACAC
TCAAGGATAACAGAGCGCCTAAAA -> CAAGGATAACAGAGCGCCTAAAAA
CCTCCCCCCCGGATCACTAGGGGC -> CTCCCCCCCGGATCACTAGGGGCT
CATATAATCGACGAAGGCTTTAGA -> ATATAATCGACGAAGGCTTTAGAT
TCCAGCTTTCTTCGAATGCTTCAT -> CCAGCTTTCTTCGAATGCTTCATC
CATGCTCTCGTAAGTTTTACATTC -> ATGCTCTCGTAAGTTTTACATTCG
ACTCGGAGCTCTCGCATGGGGACG -> CTCGGAGCTCTCGCATGGGGACGA
GTGACTACTCGATACCCCTGATAC -> TGACTACTCGATACCCCTGATACC
AAGAGGGACCTGCCAACTTCTACG -> AGAGGGACCTGCCAACTTCTACGA
CAGCAGCACCTGCCTATATTGTCG -> AGCAGCACCTGCCTATATTGTCGT
CTTAACACACGGAGGCCGAAAGCA -> TTAACACACGGAGGCCGAAAGCAT
ACCCTTCCTGCTGCACCCTAGGTT -> CCCTTCCTGCTGCACCCTAGGTTC
ACTGCATGTATCCATCGCAGAGGG -> CTGCATGTATCCATCGCAGAGGGG
CCTGCTTTCCGATTGGATTGGGAA -> CTGCTTTCCGATTGGATTGGGAAC
TAAGTTTTACATTCGATGGACGCT -> AAGTTTTACATTCGATGGACGCTG
GTCTCTTTCTTGGCACCACCACCC -> TCTCTTTCTTGGCACCACCACCCA
GGAATCCGTGCTGGAGGGGCAAGC -> GAATCCGTGCTGGAGGGGCAAGCC
TGCTCAACACTCCTGCAAGGCCTG -> GCTCAACACTCCTGCAAGGCCTGG
CTGAGGTTCTCTTTTCGTCTCCGA -> TGAGGTTCTCTTTTCGTCTCCGAA
TAACAGAGCGCCTAAAAAAATACG -> AACAGAGCGCCTAAAAAAATACGA
GCGTCACCGCAATACGGCTGAGGT -> CGTCACCGCAATACGGCTGAGGTT
TTACATTCGATGGACGCTGCTCTT -> TACATTCGATGGACGCTGCTCTTG
TTCCGATTGGATTGGGAACCGCAA -> TCCGATTGGATTGGGAACCGCAAT
TGCAAGGCCTGGTGTCCCCCGATA -> GCAAGGCCTGGTGTCCCCCGATAA
GTCACTGGGGAGATGTACCTTGAC -> TCACTGGGGAGATGTACCTTGACA
GCATAGGCCGAAGGGCCGCGAACA -> CATAGGCCGAAGGGCCGCGAACAC
ACAATCTAACCCGTCCGTCTCTTT -> CAATCTAACCCGTCCGTCTCTTTC
TCGTAGTTCTGCGTCACCGCAATA -> CGTAGTTCTGCGTCACCGCAATAC
GTCTTTGGCAGCCTCTTTAGCTGC -> TCTTTGGCAGCCTCTTTAGCTGCA
ATCACTGCATGTATCCATCGCAGA -> TCACTGCATGTATCCATCGCAGAG
AGATCACTATGCCTTGACTTTGCC -> GATCACTATGCCTTGACTTTGCCT
TTTTCAACTTGTCAGCAAGTCGGA -> TTTCAACTTGTCAGCAAGTCGGAG
CACTACGCCCTGCTTTCCGATTGG -> ACTACGCCCTGCTTTCCGATTGGA
AGTGGCTCCGACCGGAACGGAAAT -> GTGGCTCCGACCGGAACGGAAATC
TGGCAGCCTCTTTAGCTGCATATA -> GGCAGCCTCTTTAGCTGCATATAA
TCTCGCGTACGATATCAATCACTG -> CTCGCGTACGATATCAATCACTGC
GGAGACATCAACTGGACAGAAGTG -> GAGACATCAACTGGACAGAAGTGA
TTCTGTCCGCGACATGGGAGGCCC -> TCTGTCCGCGACATGGGAGGCCCG
CAAGTAACCTAGTAGGGCCGGTGC -> AAGTAACCTAGTAGGGCCGGTGCT
CACGCATAGGCCGAAGGGCCGCGA -> ACGCATAGGCCGAAGGGCCGCGAA
AGCTGCATATAATCGACGAAGGCT -> GCTGCATATAATCGACGAAGGCTT
AACACACGGAGGCCGAAAGCATTA -> ACACACGGAGGCCGAAAGCATTAT
GAACACCGGGAATGATCAAATAAG -> AACACCGGGAATGATCAAATAAGT
TCACCGCAATACGGCTGAGGTTCT -> CACCGCAATACGGCTGAGGTTCTC
GGTATTTTTTCTCGTAGTTCTGCG -> GTATTTTTTCTCGTAGTTCTGCGT
CGCATCATTTGGCCCTCTTATTAA -> GCATCATTTGGCCCTCTTATTAAG
CCTTTAAACAGTGCTATGGGGAAT -> CTTTAAACAGTGCTATGGGGAATG
TGCCTATATTGTCGTCGCAACGAT -> GCCTATATTGTCGTCGCAACGATT
GAAGGCTTTAGATACACGTCTCGA -> AAGGCTTTAGATACACGTCTCGAA
CAGCAAGTCGGAGGTGTGGCAAGG -> AGCAAGTCGGAGGTGTGGCAAGGT
ATAACTGCGGTGTGCTCGCGAACG -> TAACTGCGGTGTGCTCGCGAACGC
ACTGGGGAGATGTACCTTGACACC -> CTGGGGAGATGTACCTTGACACCG
CCCCTGATACCAGCGCATCATTTG -> CCCTGATACCAGCGCATCATTTGG
CTGCGGTGTGCTCGCGAACGCCTC -> TGCGGTGTGCTCGCGAACGCCTCG
ATCGTGATAGTCACTGGGGAGATG -> TCGTGATAGTCACTGGGGAGATGT
AGAACAAGTTGACCCTTCCTGCTG -> GAACAAGTTGACCCTTCCTGCTGC
TGACCTTATCTATTCCAGCTTTCT -> GACCTTATCTATTCCAGCTTTCTT
ACCATATATGTAGCTAGTGTCGCG -> CCATATATGTAGCTAGTGTCGCGT
GTAATCACGCATAGGCCGAAGGGC -> TAATCACGCATAGGCCGAAGGGCC
GGAGAACAAGTTGACCCTTCCTGC -> GAGAACAAGTTGACCCTTCCTGCT
AGCGACCTCAACCTGTTACTCCCA -> GCGACCTCAACCTGTTACTCCCAT
CTACGATCTGGACCATCGCAGGAG -> TACGATCTGGACCATCGCAGGAGA
GTTTCACTAGTCAATTTGCACTAC -> TTTCACTAGTCAATTTGCACTACG
ACACCGCAACTTTCTCACCGGAGA -> CACCGCAACTTTCTCACCGGAGAC
TCCCTTCATCTCTGCCTAATGACC -> CCCTTCATCTCTGCCTAATGACCT
TTTAAACAGTGCTATGGGGAATGC -> TTAAACAGTGCTATGGGGAATGCT
ACAACAAAAAGTGCGGTCGCCGTT -> CAACAAAAAGTGCGGTCGCCGTTT
TAAACAGTGCTATGGGGAATGCTC -> AAACAGTGCTATGGGGAATGCTCA
CATTCGATGGACGCTGCTCTTGCC -> ATTCGATGGACGCTGCTCTTGCCA
GTCGGAGGTGTGGCAAGGTTTCAC -> TCGGAGGTGTGGCAAGGTTTCACT
GCTTAACACACGGAGGCCGAAAGC -> CTTAACACACGGAGGCCGAAAGCA
CAACTGGACAGAAGTGACTGACAC -> AACTGGACAGAAGTGACTGACACG
CGGATCACTAGGGGCTGGATTCCG -> GGATCACTAGGGGCTGGATTCCGA
CCCACATCGTGGTGTATGCCATCA -> CCACATCGTGGTGTATGCCATCAT
GTAGTTCTGCGTCACCGCAATACG -> TAGTTCTGCGTCACCGCAATACGG
CGTAGTTCTGCGTCACCGCAATAC -> GTAGTTCTGCGTCACCGCAATACG
ACCAGTACTTGGTTTGATACAGTC -> CCAGTACTTGGTTTGATACAGTCT
CATTTGGAATCCATCCAATAAAAC -> ATTTGGAATCCATCCAATAAAACT
CGCGGGGCAATCCTCTGACAATAT -> GCGGGGCAATCCTCTGACAATATA
TGGGTTCGGGCTCCAGGTCACCCT -> GGGTTCGGGCTCCAGGTCACCCTC
ACTATTCTTTAAGGCATGCTCTCG -> CTATTCTTTAAGGCATGCTCTCGT
ACCATCGCAGGAGAACAAGTTGAC -> CCATCGCAGGAGAACAAGTTGACC
GGGGCAATCCTCTGACAATATAGA -> GGGCAATCCTCTGACAATATAGAT
AAGTTTTACATTCGATGGACGCTG -> AGTTTTACATTCGATGGACGCTGC
TTGCACTACGCCCTGCTTTCCGAT -> TGCACTACGCCCTGCTTTCCGATT
GATTCGCCTGGGCTGGTCAAAAGA -> ATTCGCCTGGGCTGGTCAAAAGAT
TAGAGAACACCGGGAATGATCAAA -> AGAGAACACCGGGAATGATCAAAT
AGGGGGACAACAAAAAGTGCGGTC -> GGGGGACAACAAAAAGTGCGGTCG
CATAGTATTTTTGAGACCGAAACC -> ATAGTATTTTTGAGACCGAAACCC
TTTCCTTTAAACAGTGCTATGGGG -> TTCCTTTAAACAGTGCTATGGGGA
TCCGACTATAGGAATCCGTGCTGG -> CCGACTATAGGAATCCGTGCTGGA
CTCGCGAACGCCTCGCGCACCAGT -> TCGCGAACGCCTCGCGCACCAGTA
CCCGTCCCTCGTAGTCCCCCAGCA -> CCGTCCCTCGTAGTCCCCCAGCAG
TCCGAAAGATTCGTCCGACTATAG -> CCGAAAGATTCGTCCGACTATAGG
CGCACCAGTACTTGGTTTGATACA -> GCACCAGTACTTGGTTTGATACAG
CTGCATATAATCGACGAAGGCTTT -> TGCATATAATCGACGAAGGCTTTA
ACTAGTCAATTTGCACTACGCCCT -> CTAGTCAATTTGCACTACGCCCTG
ACCTGCCAACTTCTACGATCTGGA -> CCTGCCAACTTCTACGATCTGGAC
CAACTTGTCAGCAAGTCGGAGGTG -> AACTTGTCAGCAAGTCGGAGGTGT
AAGAACATCTTTGCCAGACAAGTA -> AGAACATCTTTGCCAGACAAGTAA
CTAGGGTGACGTCGCGATTAATGG -> TAGGGTGACGTCGCGATTAATGGA
TGAGACCGAAACCCCTGATCTCAA -> GAGACCGAAACCCCTGATCTCAAA
TTGGCACCACCACCCATCGTGATA -> TGGCACCACCACCCATCGTGATAG
CTACAAAAATACCAGTCAACCAGA -> TACAAAAATACCAGTCAACCAGAT
TGCACCCTAGGTTCAAGGATAACA -> GCACCCTAGGTTCAAGGATAACAG
ATACCCCTGATACCAGCGCATCAT -> TACCCCTGATACCAGCGCATCATT
ATCAGTCTTTGGCAGCCTCTTTAG -> TCAGTCTTTGGCAGCCTCTTTAGC
ATACACGTCTCGAACATGGTCCCT -> TACACGTCTCGAACATGGTCCCTT
AATCCGTGCTGGAGGGGCAAGCCC -> ATCCGTGCTGGAGGGGCAAGCCCC
CTCGTAGTCCCCCAGCAGCACCTG -> TCGTAGTCCCCCAGCAGCACCTGC
TCTACGATCTGGACCATCGCAGGA -> CTACGATCTGGACCATCGCAGGAG
TGCATATAATCGACGAAGGCTTTA -> GCATATAATCGACGAAGGCTTTAG
GTTTTACATTCGATGGACGCTGCT -> TTTTACATTCGATGGACGCTGCTC
ACCTTATCTATTCCAGCTTTCTTC -> CCTTATCTATTCCAGCTTTCTTCG
AAATAAGTTAGTTCCTGAGCGACC -> AATAAGTTAGTTCCTGAGCGACCT
CCCTGCTTTCCGATTGGATTGGGA -> CCTGCTTTCCGATTGGATTGGGAA
TCTCGAACATGGTCCCTTCATCTC -> CTCGAACATGGTCCCTTCATCTCT
GTCCGACTATAGGAATCCGTGCTG -> TCCGACTATAGGAATCCGTGCTGG
CAAGGCCTGGTGTCCCCCGATAAG -> AAGGCCTGGTGTCCCCCGATAAGA
CGATCAGATCCCATTTGGAATCCA -> GATCAGATCCCATTTGGAATCCAT
CACCCTAGGTTCAAGGATAACAGA -> ACCCTAGGTTCAAGGATAACAGAG
CGATACCCCTGATACCAGCGCATC -> GATACCCCTGATACCAGCGCATCA
ACCACCCATCGTGATAGTCACTGG -> CCACCCATCGTGATAGTCACTGGG
TAGTGGCTCCGACCGGAACGGAAA -> AGTGGCTCCGACCGGAACGGAAAT
TATGGGGAATGCTCAACACTCCTG -> ATGGGGAATGCTCAACACTCCTGC
AAAGATTCGTCCGACTATAGGAAT -> AAGATTCGTCCGACTATAGGAATC
CATGGTCCCTTCATCTCTGCCTAA -> ATGGTCCCTTCATCTCTGCCTAAT
GAGCTCTCGCATGGGGACGATCCA -> AGCTCTCGCATGGGGACGATCCAG
GGCATGCTCTCGTAAGTTTTACAT -> GCATGCTCTCGTAAGTTTTACATT
GCAACTTTCTCACCGGAGACACGT -> CAACTTTCTCACCGGAGACACGTA
GCAACGATTCGATCAGATCCCATT -> CAACGATTCGATCAGATCCCATTT
CCAGCGCATCATTTGGCCCTCTTA -> CAGCGCATCATTTGGCCCTCTTAT
GGAAATCTTTTAGGGGGACAACAA -> GAAATCTTTTAGGGGGACAACAAA
GCACCCTAGGTTCAAGGATAACAG -> CACCCTAGGTTCAAGGATAACAGA
CGGTGTGCTCGCGAACGCCTCGCG -> GGTGTGCTCGCGAACGCCTCGCGC
TACGATCTGGACCATCGCAGGAGA -> ACGATCTGGACCATCGCAGGAGAA
GATCTGGACCATCGCAGGAGAACA -> ATCTGGACCATCGCAGGAGAACAA
ATACCAGTCAACCAGATTCGCCTG -> TACCAGTCAACCAGATTCGCCTGG
TCCTGCTGCACCCTAGGTTCAAGG -> CCTGCTGCACCCTAGGTTCAAGGA
TGTAGCTAGTGTCGCGTAGCGTGA -> GTAGCTAGTGTCGCGTAGCGTGAC
CCAGACAAGTAACCTAGTAGGGCC -> CAGACAAGTAACCTAGTAGGGCCG
GTGCTGTGTTGTTGTTGGTCATAG -> TGCTGTGTTGTTGTTGGTCATAGT
TTTAGGGGGACAACAAAAAGTGCG -> TTAGGGGGACAACAAAAAGTGCGG
GGTGTGCTCGCGAACGCCTCGCGC -> GTGTGCTCGCGAACGCCTCGCGCA
ATTCTTTAAGGCATGCTCTCGTAA -> TTCTTTAAGGCATGCTCTCGTAAG
TCTAGGGTGACGTCGCGATTAATG -> CTAGGGTGACGTCGCGATTAATGG
CTTTGCCAGACAAGTAACCTAGTA -> TTTGCCAGACAAGTAACCTAGTAG
AAGCCCCCGTAAGGACGTGGATAA -> AGCCCCCGTAAGGACGTGGATAAA
TATAATCGACGAAGGCTTTAGATA -> ATAATCGACGAAGGCTTTAGATAC
GGGTTGTCCACTACCTTAGTGGCT -> GGTTGTCCACTACCTTAGTGGCTC
CCATCATCTATGTGATACAATCTA -> CATCATCTATGTGATACAATCTAA
CTAACCCGTCCGTCTCTTTCTTGG -> TAACCCGTCCGTCTCTTTCTTGGC