AAAAATCGGAA -> AAAATCGGAAC
AAAACCGTCAT -> AAACCGTCATA
AAAACGAATCG -> AAACGAATCGT
AAAAGGGGTTC -> AAAGGGGTTCG
AAAATATCGTT -> AAATATCGTTC
AAAATCGGAAC -> AAATCGGAACC
AAAATGGTTGC -> AAATGGTTGCC
AAAATTATTCG -> AAATTATTCGA
AAACAACGCTC -> AACAACGCTCC
AAACCAGAACG -> AACCAGAACGA
AAACCCGATTT -> AACCCGATTTC
AAACCCTCCGT -> AACCCTCCGTG
AAACCGAAGTT -> AACCGAAGTTG
AAACCGTCATA -> AACCGTCATAC
AAACGAACAGT -> AACGAACAGTC
AAACGAATCGT -> AACGAATCGTT
AAACGGCGGAG -> AACGGCGGAGC
AAACGTCAACA -> AACGTCAACAG
AAACTACGCCC -> AACTACGCCCC
AAACTTTAGGA -> AACTTTAGGAC
AAAGAATGAAG -> AAGAATGAAGT
AAAGATAGGCC -> AAGATAGGCCA
AAAGCTACGTC -> AAGCTACGTCT
AAAGGGGTTCG -> AAGGGGTTCGC
AAATATCGTTC -> AATATCGTTCG
AAATCCCGGCC -> AATCCCGGCCA
AAATCGGAACC -> AATCGGAACCC
AAATGAAGTAG -> AATGAAGTAGA
AAATGACCCCT -> AATGACCCCTA
AAATGGTTGCC -> AATGGTTGCCA
AAATTATTCGA -> AATTATTCGAC
AAATTGTGGTG -> AATTGTGGTGG
AACAACGCTCC -> ACAACGCTCCT
AACACAAACCC -> ACACAAACCCG
AACACACGCTT -> ACACACGCTTG
AACACAGGTAT -> ACACAGGTATG
AACACCGAAAC -> ACACCGAAACC
AACACTAACAG -> ACACTAACAGT
AACACTGAACT -> ACACTGAACTG
AACAGAAACTA -> ACAGAAACTAC
AACAGACGCAG -> ACAGACGCAGA
AACAGGGGGAG -> ACAGGGGGAGC
AACAGTAATGA -> ACAGTAATGAG
AACAGTCTCTT -> ACAGTCTCTTC
AACCAACACAC -> ACCAACACACG
AACCAGAACGA -> ACCAGAACGAT
AACCATGGTAG -> ACCATGGTAGC
AACCCAATAAT -> ACCCAATAATT
AACCCGATTTC -> ACCCGATTTCA
AACCCTCCGTG -> ACCCTCCGTGG
AACCGAAGTTG -> ACCGAAGTTGC
AACCGAGTTCA -> ACCGAGTTCAT
AACCGGTGCCT -> ACCGGTGCCTG
AACCGTCATAC -> ACCGTCATACC
AACCTCAGATC -> ACCTCAGATCG
AACGAACAGTC -> ACGAACAGTCT
AACGAATCGTT -> ACGAATCGTTA
AACGACGAAAG -> ACGACGAAAGA
AACGATCTCAG -> ACGATCTCAGT
AACGATGTTGC -> ACGATGTTGCA
AACGCACCGCT -> ACGCACCGCTT
AACGCTATACA -> ACGCTATACAT
AACGCTCCTTG -> ACGCTCCTTGG
AACGGACATTC -> ACGGACATTCG
AACGGAGTTGG -> ACGGAGTTGGA
AACGGATGAGG -> ACGGATGAGGA
AACGGCGGAGC -> ACGGCGGAGCC
AACGGCGTTAC -> ACGGCGTTACT
AACGTAGATAA -> ACGTAGATAAA
AACGTCAACAG -> ACGTCAACAGA
AACGTCTAGAC -> ACGTCTAGACT
AACTACGCCCC -> ACTACGCCCCA
AACTACGCGAG -> ACTACGCGAGT
AACTGCCGACT -> ACTGCCGACTT
AACTTTAGGAC -> ACTTTAGGACT
AAGAAACCGAA -> AGAAACCGAAG
AAGAACAGGGG -> AGAACAGGGGG
AAGAAGAGGGT -> AGAAGAGGGTA
AAGAATGAAGT -> AGAATGAAGTT
AAGACGAAAAC -> AGACGAAAACC
AAGACGTGATG -> AGACGTGATGA
AAGAGGGTATA -> AGAGGGTATAA
AAGAGTTTACA -> AGAGTTTACAA
AAGATAGGCCA -> AGATAGGCCAG
AAGATCTATAG -> AGATCTATAGT
AAGATGGTTTT -> AGATGGTTTTT
AAGCACGTAGT -> AGCACGTAGTG
AAGCATTCCAA -> AGCATTCCAAG
AAGCTACGTCT -> AGCTACGTCTG
AAGGAATGTTG -> AGGAATGTTGG
AAGGAGCTTCT -> AGGAGCTTCTC
AAGGCAGATAA -> AGGCAGATAAG
AAGGGGGCGTT -> AGGGGGCGTTC
AAGGGGTTCGC -> AGGGGTTCGCT
AAGGTATGGGC -> AGGTATGGGCG
AAGGTGCCGAG -> AGGTGCCGAGC
AAGTAAACCAG -> AGTAAACCAGA
AAGTAGAGTGA -> AGTAGAGTGAT
AAGTCACAACG -> AGTCACAACGG
AAGTCTAATTG -> AGTCTAATTGT
AAGTGAAAAGG -> AGTGAAAAGGG
AAGTGTTGAAA -> AGTGTTGAAAT
AAGTTCCCTTG -> AGTTCCCTTGG
AAGTTCGCCTA -> AGTTCGCCTAG
AAGTTGCTCTG -> AGTTGCTCTGC
AAGTTTCACAT -> AGTTTCACATT
AATAATTAATT -> ATAATTAATTG
AATACAGGCTT -> ATACAGGCTTT
AATACCGATCG -> ATACCGATCGA
AATAGTGAACC -> ATAGTGAACCA
AATATCGTTCG -> ATATCGTTCGC
AATCCCGGCCA -> ATCCCGGCCAC
AATCGGAACCC -> ATCGGAACCCA
AATCGTTATTA -> ATCGTTATTAT
AATCTTGGGTA -> ATCTTGGGTAT
AATGAAGTAGA -> ATGAAGTAGAG
AATGAAGTTCG -> ATGAAGTTCGC
AATGACCCCTA -> ATGACCCCTAT
AATGAGCCAAC -> ATGAGCCAACC
AATGCAATTAA -> ATGCAATTAAG
AATGGTCCACG -> ATGGTCCACGG
AATGGTTCGTC -> ATGGTTCGTCG
AATGGTTGCCA -> ATGGTTGCCAA
AATGTTGGACT -> ATGTTGGACTG
AATTAACTACG -> ATTAACTACGC
AATTAAGTCAC -> ATTAAGTCACA
AATTAATTGTA -> ATTAATTGTAA
AATTATTCGAC -> ATTATTCGACA
AATTCCGAGCG -> ATTCCGAGCGT
AATTGAATTCC -> ATTGAATTCCG
AATTGTAACGG -> ATTGTAACGGA
AATTGTGGTGG -> ATTGTGGTGGA
AATTGTTTAAA -> ATTGTTTAAAC
ACAAAAATCGG -> CAAAAATCGGA
ACAAACCCGAT -> CAAACCCGATT
ACAAATGAAGT -> CAAATGAAGTA
ACAACACCGAA -> CAACACCGAAA
ACAACGCACCG -> CAACGCACCGC
ACAACGCTCCT -> CAACGCTCCTT
ACAACGGAGTT -> CAACGGAGTTG
ACAACGGATGA -> CAACGGATGAG
ACAACGTCTAG -> CAACGTCTAGA
ACAAGTTCCCT -> CAAGTTCCCTT
ACACAAACCCG -> CACAAACCCGA
ACACAACGCAC -> CACAACGCACC
ACACACGCTTG -> CACACGCTTGA
ACACAGGTATG -> CACAGGTATGA
ACACCGAAACC -> CACCGAAACCC
ACACCGGGGCC -> CACCGGGGCCC
ACACCTTACTT -> CACCTTACTTC
ACACGCACAAC -> CACGCACAACG
ACACGCCAGAG -> CACGCCAGAGC
ACACGCTTGAA -> CACGCTTGAAG
ACACGTCAAAA -> CACGTCAAAAT
ACACTAACAGT -> CACTAACAGTA
ACACTCGCGGA -> CACTCGCGGAC
ACACTGAACTG -> CACTGAACTGC
ACAGAAACTAC -> CAGAAACTACG
ACAGAAGTCTA -> CAGAAGTCTAA
ACAGACACTCG -> CAGACACTCGC
ACAGACGCAGA -> CAGACGCAGAT
ACAGACTGGTA -> CAGACTGGTAA
ACAGGCTTTAT -> CAGGCTTTATA
ACAGGGGGAGC -> CAGGGGGAGCT
ACAGGTATGAT -> CAGGTATGATT
ACAGTAACGGC -> CAGTAACGGCG
ACAGTAATGAG -> CAGTAATGAGC
ACAGTCTCTTC -> CAGTCTCTTCG
ACAGTGGTGAG -> CAGTGGTGAGC
ACATAAAATAT -> CATAAAATATC
ACATATTCGAG -> CATATTCGAGG
ACATCTTATTT -> CATCTTATTTG
ACATCTTCGTC -> CATCTTCGTCA
ACATGCCCAAC -> CATGCCCAACG
ACATTCCTATT -> CATTCCTATTA
ACATTCGTCTA -> CATTCGTCTAT
ACATTGGGGCC -> CATTGGGGCCT
ACATTTTGGGG -> CATTTTGGGGG
ACCAACACACG -> CCAACACACGC
ACCAACGACGA -> CCAACGACGAA
ACCAGAACGAT -> CCAGAACGATG
ACCATGGTAGC -> CCATGGTAGCA
ACCCAATAATT -> CCCAATAATTA
ACCCCTATTGA -> CCCCTATTGAA
ACCCGATTTCA -> CCCGATTTCAC
ACCCTCCGTGG -> CCCTCCGTGGA
ACCCTCTGTAC -> CCCTCTGTACG
ACCGAAACCCT -> CCGAAACCCTC
ACCGAAGTTGC -> CCGAAGTTGCT
ACCGAGTTCAT -> CCGAGTTCATA
ACCGATCGAAC -> CCGATCGAACA
ACCGCGAGAGA -> CCGCGAGAGAC
ACCGCTTGTTT -> CCGCTTGTTTA
ACCGGAGACTC -> CCGGAGACTCG
ACCGGGGCCCG -> CCGGGGCCCGA
ACCGGTAATTG -> CCGGTAATTGA
ACCGGTGCCTG -> CCGGTGCCTGG
ACCGTCATACC -> CCGTCATACCA
ACCTCAGATCG -> CCTCAGATCGG
ACCTCGAAGAA -> CCTCGAAGAAA
ACCTTACATAT -> CCTTACATATT
ACCTTACTTCA -> CCTTACTTCAT
ACCTTAGACCT -> CCTTAGACCTT
ACCTTCTTTCA -> CCTTCTTTCAT
ACGAAAACCGT -> CGAAAACCGTC
ACGAAAGAATG -> CGAAAGAATGA
ACGAACAGTCT -> CGAACAGTCTC
ACGAATCGTTA -> CGAATCGTTAT
ACGACAAATGA -> CGACAAATGAA
ACGACAGTGGT -> CGACAGTGGTG
ACGACCTTAGA -> CGACCTTAGAC
ACGACGAAAGA -> CGACGAAAGAA
ACGATCTCAGT -> CGATCTCAGTG
ACGATGTTGCA -> CGATGTTGCAC
ACGCACAACGG -> CGCACAACGGA
ACGCACCGCTT -> CGCACCGCTTG
ACGCACTATTG -> CGCACTATTGT
ACGCAGATTAC -> CGCAGATTACA
ACGCCAGAGCT -> CGCCAGAGCTG
ACGCCCCAAGG -> CGCCCCAAGGT
ACGCGAGTGTG -> CGCGAGTGTGG
ACGCTATACAT -> CGCTATACATA
ACGCTCCTTGG -> CGCTCCTTGGA
ACGCTTGAAGT -> CGCTTGAAGTG
ACGGACATTCG -> CGGACATTCGT
ACGGAGTTGGA -> CGGAGTTGGAA
ACGGATGAGGA -> CGGATGAGGAG
ACGGCGGAGCC -> CGGCGGAGCCG
ACGGCGTTACT -> CGGCGTTACTA
ACGGCTTAGCA -> CGGCTTAGCAC
ACGGGATTGAA -> CGGGATTGAAA
ACGGTTCACGA -> CGGTTCACGAC
ACGTAGATAAA -> CGTAGATAAAC
ACGTAGTGCGC -> CGTAGTGCGCA
ACGTCAAAATT -> CGTCAAAATTA
ACGTCAACAGA -> CGTCAACAGAC
ACGTCTAGACT -> CGTCTAGACTG
ACGTCTGCAAG -> CGTCTGCAAGG
ACGTGATGAGA -> CGTGATGAGAC
ACGTGCAAGAC -> CGTGCAAGACG
ACGTTCGTGCC -> CGTTCGTGCCC
ACTAACACTAA -> CTAACACTAAC
ACTAACAGTAA -> CTAACAGTAAT
ACTAAGGTGCC -> CTAAGGTGCCG
ACTAAGTGAAA -> CTAAGTGAAAA
ACTAATGCAAT -> CTAATGCAATT
ACTACGCCCCA -> CTACGCCCCAA
ACTACGCGAGT -> CTACGCGAGTG
ACTAGCACGTG -> CTAGCACGTGC
ACTAGGCCTGG -> CTAGGCCTGGA
ACTATTGTAGG -> CTATTGTAGGG
ACTCCATATCC -> CTCCATATCCC
ACTCGCGGACA -> CTCGCGGACAC
ACTCGGCCGTG -> CTCGGCCGTGA
ACTGAAATTGT -> CTGAAATTGTG
ACTGAACTGCC -> CTGAACTGCCG
ACTGACCGCGA -> CTGACCGCGAG
ACTGACTTCAC -> CTGACTTCACC
ACTGCCGACTT -> CTGCCGACTTG
ACTGGTAAAGA -> CTGGTAAAGAT
ACTGTATTGGA -> CTGTATTGGAT
ACTGTCGCCAA -> CTGTCGCCAAC
ACTTAGCGACT -> CTTAGCGACTA
ACTTCACCGGT -> CTTCACCGGTA
ACTTCATACAA -> CTTCATACAAC
ACTTGGCCGCT -> CTTGGCCGCTG
ACTTTAGCATC -> CTTTAGCATCC
ACTTTAGGACT -> CTTTAGGACTA
ACTTTCTAAGA -> CTTTCTAAGAA
ACTTTGTATCG -> CTTTGTATCGT
AGAAACCGAAG -> GAAACCGAAGT
AGAAACGTCAA -> GAAACGTCAAC
AGAAACTACGC -> GAAACTACGCC
AGAACAGGGGG -> GAACAGGGGGA
AGAACGATGTT -> GAACGATGTTG
AGAAGACGTGA -> GAAGACGTGAT
AGAAGAGGGTA -> GAAGAGGGTAT
AGAAGTCTAAT -> GAAGTCTAATT
AGAATGAAGTT -> GAATGAAGTTC
AGACACTCGCG -> GACACTCGCGG
AGACCTTACAT -> GACCTTACATA
AGACGAAAACC -> GACGAAAACCG
AGACGCAGATT -> GACGCAGATTA
AGACGGTTCAC -> GACGGTTCACG
AGACGTGATGA -> GACGTGATGAG
AGACTAGGCCT -> GACTAGGCCTG
AGACTCCATAT -> GACTCCATATC
AGACTCGGCCG -> GACTCGGCCGT
AGACTGACTTC -> GACTGACTTCA
AGACTGGTAAA -> GACTGGTAAAG
AGACTTAGCGA -> GACTTAGCGAC
AGAGACTTAGC -> GAGACTTAGCG
AGAGATAAAGC -> GAGATAAAGCT
AGAGCTGTAAG -> GAGCTGTAAGG
AGAGGGTATAA -> GAGGGTATAAC
AGAGTGATGCC -> GAGTGATGCCT
AGAGTTTACAA -> GAGTTTACAAC
AGATAAACGGC -> GATAAACGGCG
AGATAAAGCTA -> GATAAAGCTAC
AGATAAGGAGC -> GATAAGGAGCT
AGATAGGCCAG -> GATAGGCCAGT
AGATCGGATGG -> GATCGGATGGT
AGATCTATAGT -> GATCTATAGTC
AGATGGTTTTT -> GATGGTTTTTT
AGATTACACGC -> GATTACACGCC
AGATTCCATGG -> GATTCCATGGG
AGATTTTCAAT -> GATTTTCAATC
AGCACGTAGTG -> GCACGTAGTGC
AGCACGTGCAA -> GCACGTGCAAG
AGCACTTTAGC -> GCACTTTAGCA
AGCAGGTGGAG -> GCAGGTGGAGG
AGCAGTGTCCA -> GCAGTGTCCAG
AGCATAGAGAT -> GCATAGAGATA
AGCATCACATC -> GCATCACATCT
AGCATCCGATG -> GCATCCGATGT
AGCATTCCAAG -> GCATTCCAAGC
AGCCAACCGGT -> GCCAACCGGTG
AGCCAAGATGG -> GCCAAGATGGT
AGCCGTGGTAA -> GCCGTGGTAAC
AGCCGTTGTTA -> GCCGTTGTTAG
AGCGACTAGCA -> GCGACTAGCAC
AGCGTCGGAAG -> GCGTCGGAAGG
AGCTACGTCTG -> GCTACGTCTGC
AGCTAGCAGGT -> GCTAGCAGGTG
AGCTATGTCGC -> GCTATGTCGCC
AGCTCCCCTCT -> GCTCCCCTCTT
AGCTCCTCCGG -> GCTCCTCCGGC
AGCTGAAAACG -> GCTGAAAACGA
AGCTGTAAGGA -> GCTGTAAGGAA
AGCTTCTCATG -> GCTTCTCATGA
AGCTTCTCTTT -> GCTTCTCTTTG
AGGAACACAGG -> GGAACACAGGT
AGGAATGTTGG -> GGAATGTTGGA
AGGACGTTCGT -> GGACGTTCGTG
AGGACTAATGC -> GGACTAATGCA
AGGAGACTCCA -> GGAGACTCCAT
AGGAGCTTCTC -> GGAGCTTCTCA
AGGAGTTAGGA -> GGAGTTAGGAC
AGGCAGATAAG -> GGCAGATAAGG
AGGCATCATTC -> GGCATCATTCG
AGGCCAGTCAT -> GGCCAGTCATG
AGGCCATCGTG -> GGCCATCGTGT
AGGCCCAACGC -> GGCCCAACGCT
AGGCCTGCTTG -> GGCCTGCTTGA
AGGCCTGGATG -> GGCCTGGATGC
AGGCTTTATAA -> GGCTTTATAAA
AGGGGGAGCTG -> GGGGGAGCTGA
AGGGGGCGTTC -> GGGGGCGTTCG
AGGGGTTCGCT -> GGGGTTCGCTG
AGGGTAAGTAA -> GGGTAAGTAAA
AGGGTATAACC -> GGGTATAACCT
AGGTATGATTT -> GGTATGATTTC
AGGTATGGGCG -> GGTATGGGCGG
AGGTCATCACA -> GGTCATCACAT
AGGTGCCGAGC -> GGTGCCGAGCT
AGGTGGAGGTC -> GGTGGAGGTCA
AGTAAACCAGA -> GTAAACCAGAA
AGTAACGGCGT -> GTAACGGCGTT
AGTAATGAGCC -> GTAATGAGCCA
AGTACACGTCA -> GTACACGTCAA
AGTAGAGTGAT -> GTAGAGTGATG
AGTAGTGTTGC -> GTAGTGTTGCG
AGTCACAACGG -> GTCACAACGGA
AGTCATAGAAA -> GTCATAGAAAC
AGTCATATTGT -> GTCATATTGTT
AGTCATGTCGA -> GTCATGTCGAG
AGTCTAATTGT -> GTCTAATTGTT
AGTCTCTTCGG -> GTCTCTTCGGC
AGTGAAAAGGG -> GTGAAAAGGGG
AGTGAACCAAC -> GTGAACCAACA
AGTGATGCCTG -> GTGATGCCTGG
AGTGATGCCTT -> GTGATGCCTTC
AGTGCGCAACA -> GTGCGCAACAG
AGTGGACTGAC -> GTGGACTGACC
AGTGGTGAGCT -> GTGGTGAGCTA
AGTGTCCAGAT -> GTGTCCAGATT
AGTGTGGCCCT -> GTGTGGCCCTC
AGTGTGGGTGC -> GTGTGGGTGCT
AGTGTTGAAAT -> GTGTTGAAATG
AGTGTTGCGAT -> GTGTTGCGATG
AGTTAATGGTT -> GTTAATGGTTC
AGTTAGGACGT -> GTTAGGACGTT
AGTTAGTCATA -> GTTAGTCATAT
AGTTCATACTG -> GTTCATACTGA
AGTTCCCTTGG -> GTTCCCTTGGC
AGTTCGCCTAG -> GTTCGCCTAGT
AGTTGCTCTGC -> GTTGCTCTGCA
AGTTGGAATAG -> GTTGGAATAGT
AGTTTAAACGA -> GTTTAAACGAA
AGTTTACAACA -> GTTTACAACAC
AGTTTCACATT -> GTTTCACATTC
ATAAAATATCG -> TAAAATATCGT
ATAAACGGCGG -> TAAACGGCGGA
ATAAAGCTACG -> TAAAGCTACGT
ATAAATCCCGG -> TAAATCCCGGC
ATAACCTCAGA -> TAACCTCAGAT
ATAAGCATTCC -> TAAGCATTCCA
ATAAGGAGCTT -> TAAGGAGCTTC
ATAATTAATTG -> TAATTAATTGT
ATACAACGTCT -> TACAACGTCTA
ATACAGGCTTT -> TACAGGCTTTA
ATACATAAAAT -> TACATAAAATA
ATACATCTTAT -> TACATCTTATT
ATACCAACGAC -> TACCAACGACG
ATACCGATCGA -> TACCGATCGAA
ATACTGAAATT -> TACTGAAATTG
ATAGAAACGTC -> TAGAAACGTCA
ATAGAGATAAA -> TAGAGATAAAG
ATAGCCGTGGT -> TAGCCGTGGTA
ATAGCTAGCAG -> TAGCTAGCAGG
ATAGGCCAGTC -> TAGGCCAGTCA
ATAGTCATAGA -> TAGTCATAGAA
ATAGTGAACCA -> TAGTGAACCAA
ATATCCCAATA -> TATCCCAATAC
ATATCGTTCGC -> TATCGTTCGCT
ATATGATGGAG -> TATGATGGAGT
ATATTCGAGGC -> TATTCGAGGCC
ATATTGTTTTC -> TATTGTTTTCA
ATCACATCTTC -> TCACATCTTCG
ATCACATGCCC -> TCACATGCCCA
ATCATTCGGTC -> TCATTCGGTCG
ATCCCAATACC -> TCCCAATACCG
ATCCCGGCCAC -> TCCCGGCCACT
ATCCGATGTAT -> TCCGATGTATC
ATCCTATAGCT -> TCCTATAGCTA
ATCGAACACTG -> TCGAACACTGA
ATCGGAACCCA -> TCGGAACCCAA
ATCGGATGGTA -> TCGGATGGTAG
ATCGTACTAAG -> TCGTACTAAGG
ATCGTGTGTCT -> TCGTGTGTCTT
ATCGTTATTAT -> TCGTTATTATG
ATCGTTCGCTA -> TCGTTCGCTAG
ATCTAGGCATC -> TCTAGGCATCA
ATCTATAGTCA -> TCTATAGTCAT
ATCTCAGTGGA -> TCTCAGTGGAC
ATCTCTACGAC -> TCTCTACGACA
ATCTTATTTGT -> TCTTATTTGTC
ATCTTCGTCAC -> TCTTCGTCACT
ATCTTGGGTAT -> TCTTGGGTATT
ATCTTGTAGGA -> TCTTGTAGGAA
ATGAAGTAGAG -> TGAAGTAGAGT
ATGAAGTTCGC -> TGAAGTTCGCC
ATGAATACAGG -> TGAATACAGGC
ATGACAAAAAT -> TGACAAAAATC
ATGACCCCTAT -> TGACCCCTATT
ATGACCGGAGA -> TGACCGGAGAC
ATGACCTTCTT -> TGACCTTCTTT
ATGAGACGGTT -> TGAGACGGTTC
ATGAGCCAACC -> TGAGCCAACCG
ATGAGGAGTTA -> TGAGGAGTTAG
ATGAGGCCCAA -> TGAGGCCCAAC
ATGATGGAGTA -> TGATGGAGTAC
ATGATTTCTCA -> TGATTTCTCAT
ATGCAATTAAG -> TGCAATTAAGT
ATGCCCAACGT -> TGCCCAACGTA
ATGCCTGGTTG -> TGCCTGGTTGC
ATGCCTTCCTA -> TGCCTTCCTAG
ATGCTTTCACT -> TGCTTTCACTT
ATGGAGTACAC -> TGGAGTACACG
ATGGGCGGCCG -> TGGGCGGCCGC
ATGGGGTAGTT -> TGGGGTAGTTA
ATGGGTCCGTC -> TGGGTCCGTCC
ATGGTAGCAGT -> TGGTAGCAGTG
ATGGTAGGCCA -> TGGTAGGCCAT
ATGGTCCACGG -> TGGTCCACGGC
ATGGTTCGTCG -> TGGTTCGTCGG
ATGGTTGCCAA -> TGGTTGCCAAT
ATGGTTTTTTG -> TGGTTTTTTGG
ATGTATCTTGT -> TGTATCTTGTA
ATGTCGAGCTT -> TGTCGAGCTTC
ATGTCGCCGCC -> TGTCGCCGCCC
ATGTTCGGTCA -> TGTTCGGTCAC
ATGTTGCACAG -> TGTTGCACAGA
ATGTTGGACTG -> TGTTGGACTGT
ATGTTTTGACA -> TGTTTTGACAC
ATTAACTACGC -> TTAACTACGCG
ATTAAGTCACA -> TTAAGTCACAA
ATTAATTGTAA -> TTAATTGTAAC
ATTACACGCCA -> TTACACGCCAG
ATTAGCCAAGA -> TTAGCCAAGAT
ATTATGACCTT -> TTATGACCTTC
ATTATTCGACA -> TTATTCGACAG
ATTCCAAGCAC -> TTCCAAGCACG
ATTCCATGGGT -> TTCCATGGGTC
ATTCCGAGCGT -> TTCCGAGCGTC
ATTCCTATTAG -> TTCCTATTAGC
ATTCGACAGAC -> TTCGACAGACA
ATTCGAGGCCT -> TTCGAGGCCTG
ATTCGGTCGCA -> TTCGGTCGCAA
ATTCGTCTATT -> TTCGTCTATTT
ATTCTCTCCTA -> TTCTCTCCTAT
ATTCTTAGTTT -> TTCTTAGTTTA
ATTGAAAATGG -> TTGAAAATGGT
ATTGAACGATC -> TTGAACGATCT
ATTGAATTCCG -> TTGAATTCCGA
ATTGCTTTTTC -> TTGCTTTTTCT
ATTGGATACAT -> TTGGATACATC
ATTGGGGCCTC -> TTGGGGCCTCC
ATTGTAACGGA -> TTGTAACGGAC
ATTGTAGGGTA -> TTGTAGGGTAA
ATTGTGGTGGA -> TTGTGGTGGAC
ATTGTTTAAAC -> TTGTTTAAACT
ATTGTTTTCAC -> TTGTTTTCACA
ATTTATTCTTA -> TTTATTCTTAG
ATTTCACATTG -> TTTCACATTGG
ATTTCTCATTG -> TTTCTCATTGC
ATTTGTCGATG -> TTTGTCGATGA
ATTTTCAATCT -> TTTTCAATCTT
ATTTTGAACAC -> TTTTGAACACA
ATTTTGGGGGC -> TTTTGGGGGCC
CAAAAATCGGA -> AAAAATCGGAA
CAAAATTATTC -> AAAATTATTCG
CAAACAACGCT -> AAACAACGCTC
CAAACCCGATT -> AAACCCGATTT
CAAATGAAGTA -> AAATGAAGTAG
CAACACACGCT -> AACACACGCTT
CAACACCGAAA -> AACACCGAAAC
CAACAGAAACT -> AACAGAAACTA
CAACAGACGCA -> AACAGACGCAG
CAACCATGGTA -> AACCATGGTAG
CAACCGGTGCC -> AACCGGTGCCT
CAACGACGAAA -> AACGACGAAAG
CAACGCACCGC -> AACGCACCGCT
CAACGCTATAC -> AACGCTATACA
CAACGCTCCTT -> AACGCTCCTTG
CAACGGAGTTG -> AACGGAGTTGG
CAACGGATGAG -> AACGGATGAGG
CAACGTAGATA -> AACGTAGATAA
CAACGTCTAGA -> AACGTCTAGAC
CAAGACGAAAA -> AAGACGAAAAC
CAAGAGTTTAC -> AAGAGTTTACA
CAAGATGGTTT -> AAGATGGTTTT
CAAGCACGTAG -> AAGCACGTAGT
CAAGGGGGCGT -> AAGGGGGCGTT
CAAGGTATGGG -> AAGGTATGGGC
CAAGTTCCCTT -> AAGTTCCCTTG
CAAGTTTCACA -> AAGTTTCACAT
CAATAATTAAT -> AATAATTAATT
CAATACCGATC -> AATACCGATCG
CAATCTTGGGT -> AATCTTGGGTA
CAATGGTCCAC -> AATGGTCCACG
CAATTAAGTCA -> AATTAAGTCAC
CACAAACCCGA -> ACAAACCCGAT
CACAACGCACC -> ACAACGCACCG
CACAACGGAGT -> ACAACGGAGTT
CACAACGGATG -> ACAACGGATGA
CACACGCTTGA -> ACACGCTTGAA
CACAGAAGTCT -> ACAGAAGTCTA
CACAGACTGGT -> ACAGACTGGTA
CACAGGTATGA -> ACAGGTATGAT
CACATCTTCGT -> ACATCTTCGTC
CACATGCCCAA -> ACATGCCCAAC
CACATTCCTAT -> ACATTCCTATT
CACATTGGGGC -> ACATTGGGGCC
CACATTTTGGG -> ACATTTTGGGG
CACCCTCTGTA -> ACCCTCTGTAC
CACCGAAACCC -> ACCGAAACCCT
CACCGCTTGTT -> ACCGCTTGTTT
CACCGGGGCCC -> ACCGGGGCCCG
CACCGGTAATT -> ACCGGTAATTG
CACCTTACTTC -> ACCTTACTTCA
CACGACAAATG -> ACGACAAATGA
CACGCACAACG -> ACGCACAACGG
CACGCCAGAGC -> ACGCCAGAGCT
CACGCTTGAAG -> ACGCTTGAAGT
CACGGCTTAGC -> ACGGCTTAGCA
CACGTAGTGCG -> ACGTAGTGCGC
CACGTCAAAAT -> ACGTCAAAATT
CACGTGCAAGA -> ACGTGCAAGAC
CACTAACAGTA -> ACTAACAGTAA
CACTAAGTGAA -> ACTAAGTGAAA
CACTATTGTAG -> ACTATTGTAGG
CACTCGCGGAC -> ACTCGCGGACA
CACTGAACTGC -> ACTGAACTGCC
CACTGTATTGG -> ACTGTATTGGA
CACTTTAGCAT -> ACTTTAGCATC
CACTTTCTAAG -> ACTTTCTAAGA
CACTTTGTATC -> ACTTTGTATCG
CAGAAACTACG -> AGAAACTACGC
CAGAACGATGT -> AGAACGATGTT
CAGAAGACGTG -> AGAAGACGTGA
CAGAAGTCTAA -> AGAAGTCTAAT
CAGACACTCGC -> AGACACTCGCG
CAGACGCAGAT -> AGACGCAGATT
CAGACTGGTAA -> AGACTGGTAAA
CAGAGCTGTAA -> AGAGCTGTAAG
CAGATAAGGAG -> AGATAAGGAGC
CAGATCGGATG -> AGATCGGATGG
CAGATTACACG -> AGATTACACGC
CAGATTCCATG -> AGATTCCATGG
CAGCTCCTCCG -> AGCTCCTCCGG
CAGGAGACTCC -> AGGAGACTCCA
CAGGCTTTATA -> AGGCTTTATAA
CAGGGGGAGCT -> AGGGGGAGCTG
CAGGTATGATT -> AGGTATGATTT
CAGGTGGAGGT -> AGGTGGAGGTC
CAGTAACGGCG -> AGTAACGGCGT
CAGTAATGAGC -> AGTAATGAGCC
CAGTAGTGTTG -> AGTAGTGTTGC
CAGTCATGTCG -> AGTCATGTCGA
CAGTCTCTTCG -> AGTCTCTTCGG
CAGTGGACTGA -> AGTGGACTGAC
CAGTGGTGAGC -> AGTGGTGAGCT
CAGTGTCCAGA -> AGTGTCCAGAT
CATAAAATATC -> ATAAAATATCG
CATACAACGTC -> ATACAACGTCT
CATACCAACGA -> ATACCAACGAC
CATACTGAAAT -> ATACTGAAATT
CATAGAAACGT -> ATAGAAACGTC
CATAGAGATAA -> ATAGAGATAAA
CATAGCCGTGG -> ATAGCCGTGGT
CATATCCCAAT -> ATATCCCAATA
CATATTCGAGG -> ATATTCGAGGC
CATATTGTTTT -> ATATTGTTTTC
CATCACATCTT -> ATCACATCTTC
CATCACATGCC -> ATCACATGCCC
CATCATTCGGT -> ATCATTCGGTC
CATCCGATGTA -> ATCCGATGTAT
CATCCTATAGC -> ATCCTATAGCT
CATCGTGTGTC -> ATCGTGTGTCT
CATCTTATTTG -> ATCTTATTTGT
CATCTTCGTCA -> ATCTTCGTCAC
CATGAATACAG -> ATGAATACAGG
CATGAGGCCCA -> ATGAGGCCCAA
CATGCCCAACG -> ATGCCCAACGT
CATGGGTCCGT -> ATGGGTCCGTC
CATGGTAGCAG -> ATGGTAGCAGT
CATGTCGAGCT -> ATGTCGAGCTT
CATTCCAAGCA -> ATTCCAAGCAC
CATTCCTATTA -> ATTCCTATTAG
CATTCGGTCGC -> ATTCGGTCGCA
CATTCGTCTAT -> ATTCGTCTATT
CATTGCTTTTT -> ATTGCTTTTTC
CATTGGGGCCT -> ATTGGGGCCTC
CATTTTGGGGG -> ATTTTGGGGGC
CCAAACAACGC -> CAAACAACGCT
CCAACACACGC -> CAACACACGCT
CCAACCATGGT -> CAACCATGGTA
CCAACCGGTGC -> CAACCGGTGCC
CCAACGACGAA -> CAACGACGAAA
CCAACGCTATA -> CAACGCTATAC
CCAACGTAGAT -> CAACGTAGATA
CCAAGAGTTTA -> CAAGAGTTTAC
CCAAGATGGTT -> CAAGATGGTTT
CCAAGCACGTA -> CAAGCACGTAG
CCAAGGTATGG -> CAAGGTATGGG
CCAATAATTAA -> CAATAATTAAT
CCAATACCGAT -> CAATACCGATC
CCAATGGTCCA -> CAATGGTCCAC
CCACGGCTTAG -> CACGGCTTAGC
CCACTGTATTG -> CACTGTATTGG
CCAGAACGATG -> CAGAACGATGT
CCAGAGCTGTA -> CAGAGCTGTAA
CCAGATTCCAT -> CAGATTCCATG
CCAGTCATGTC -> CAGTCATGTCG
CCATATCCCAA -> CATATCCCAAT
CCATCGTGTGT -> CATCGTGTGTC
CCATGAGGCCC -> CATGAGGCCCA
CCATGGGTCCG -> CATGGGTCCGT
CCATGGTAGCA -> CATGGTAGCAG
CCCAACGCTAT -> CCAACGCTATA
CCCAACGTAGA -> CCAACGTAGAT
CCCAAGAGTTT -> CCAAGAGTTTA
CCCAAGGTATG -> CCAAGGTATGG
CCCAATAATTA -> CCAATAATTAA
CCCAATACCGA -> CCAATACCGAT
CCCCAAGAGTT -> CCCAAGAGTTT
CCCCAAGGTAT -> CCCAAGGTATG
CCCCTATTGAA -> CCCTATTGAAC
CCCCTCTTGGA -> CCCTCTTGGAC
CCCGACGACCT -> CCGACGACCTT
CCCGATTTCAC -> CCGATTTCACA
CCCGGAAGAAG -> CCGGAAGAAGA
CCCGGCCACTG -> CCGGCCACTGT
CCCTATTGAAC -> CCTATTGAACG
CCCTCCGTCGA -> CCTCCGTCGAC
CCCTCCGTGGA -> CCTCCGTGGAG
CCCTCTGTACG -> CCTCTGTACGC
CCCTCTTGGAC -> CCTCTTGGACA
CCCTTAGCATA -> CCTTAGCATAG
CCCTTGGCAGA -> CCTTGGCAGAA
CCGAAACCCTC -> CGAAACCCTCC
CCGAAGTTGCT -> CGAAGTTGCTC
CCGACGACCTT -> CGACGACCTTA
CCGACTTGGCC -> CGACTTGGCCG
CCGAGCGTCGG -> CGAGCGTCGGA
CCGAGCTCCCC -> CGAGCTCCCCT
CCGAGTTCATA -> CGAGTTCATAC
CCGATCGAACA -> CGATCGAACAC
CCGATGTATCT -> CGATGTATCTT
CCGATTTCACA -> CGATTTCACAT
CCGCACTAAGT -> CGCACTAAGTG
CCGCCCTTAGC -> CGCCCTTAGCA
CCGCGAGAGAC -> CGCGAGAGACT
CCGCTGGTCCA -> CGCTGGTCCAT
CCGCTTGTTTA -> CGCTTGTTTAC
CCGGAAGAAGA -> CGGAAGAAGAG
CCGGAGACTCG -> CGGAGACTCGG
CCGGCCACTGT -> CGGCCACTGTA
CCGGCTGATGG -> CGGCTGATGGG
CCGGGGCCCGA -> CGGGGCCCGAC
CCGGTAATTGA -> CGGTAATTGAA
CCGGTGCCTGG -> CGGTGCCTGGG
CCGTCATACCA -> CGTCATACCAA
CCGTCCTCTGA -> CGTCCTCTGAT
CCGTCGACGGG -> CGTCGACGGGA
CCGTGATATGA -> CGTGATATGAT
CCGTGGAGACT -> CGTGGAGACTA
CCGTGGTAACC -> CGTGGTAACCG
CCGTTGTTAGT -> CGTTGTTAGTT
CCTAGATTTTC -> CTAGATTTTCA
CCTAGTGTGGC -> CTAGTGTGGCC
CCTATAGCTAG -> CTATAGCTAGC
CCTATCTCTAC -> CTATCTCTACG
CCTATTAGCCA -> CTATTAGCCAA
CCTATTGAACG -> CTATTGAACGA
CCTCAGATCGG -> CTCAGATCGGA
CCTCCGGCTGA -> CTCCGGCTGAT
CCTCCGTCGAC -> CTCCGTCGACG
CCTCCGTGGAG -> CTCCGTGGAGA
CCTCCTCTGCC -> CTCCTCTGCCT
CCTCGAAGAAA -> CTCGAAGAAAC
CCTCTGATGTT -> CTCTGATGTTC
CCTCTGCCTGT -> CTCTGCCTGTC
CCTCTGTACGC -> CTCTGTACGCA
CCTCTTGGACA -> CTCTTGGACAC
CCTGCTTGACC -> CTGCTTGACCT
CCTGGATGCTT -> CTGGATGCTTT
CCTGGGATAAG -> CTGGGATAAGC
CCTGGTTGCTA -> CTGGTTGCTAA
CCTGTCAGTAG -> CTGTCAGTAGT
CCTTACATATT -> CTTACATATTC
CCTTACTTCAT -> CTTACTTCATA
CCTTAGACCTT -> CTTAGACCTTA
CCTTAGCATAG -> CTTAGCATAGA
CCTTCCTAGAT -> CTTCCTAGATT
CCTTCTTTCAT -> CTTCTTTCATA
CCTTGGACAGT -> CTTGGACAGTA
CCTTGGCAGAA -> CTTGGCAGAAG
CGAAAACCGTC -> GAAAACCGTCA
CGAAACCCTCC -> GAAACCCTCCG
CGAAAGAATGA -> GAAAGAATGAA
CGAACACTGAA -> GAACACTGAAC
CGAACAGTCTC -> GAACAGTCTCT
CGAAGAAACCG -> GAAGAAACCGA
CGAAGATCTAT -> GAAGATCTATA
CGAAGTTGCTC -> GAAGTTGCTCT
CGAATCGTTAT -> GAATCGTTATT
CGACAAATGAA -> GACAAATGAAG
CGACAGACACT -> GACAGACACTC
CGACAGTGGTG -> GACAGTGGTGA
CGACCTTAGAC -> GACCTTAGACC
CGACGAAAGAA -> GACGAAAGAAT
CGACGACCTTA -> GACGACCTTAG
CGACGGGATTG -> GACGGGATTGA
CGACTAGCACG -> GACTAGCACGT
CGACTTGGCCG -> GACTTGGCCGC
CGAGAGACTTA -> GAGAGACTTAG
CGAGCGTCGGA -> GAGCGTCGGAA
CGAGCTCCCCT -> GAGCTCCCCTC
CGAGCTTCTCT -> GAGCTTCTCTT
CGAGGCCTGCT -> GAGGCCTGCTT
CGAGTGTGGGT -> GAGTGTGGGTG
CGAGTTCATAC -> GAGTTCATACT
CGATCGAACAC -> GATCGAACACT
CGATCTAGGCA -> GATCTAGGCAT
CGATCTCAGTG -> GATCTCAGTGG
CGATGACAAAA -> GATGACAAAAA
CGATGTATCTT -> GATGTATCTTG
CGATGTTGCAC -> GATGTTGCACA
CGATGTTTTGA -> GATGTTTTGAC
CGATTTCACAT -> GATTTCACATT
CGCAACAGAAA -> GCAACAGAAAC
CGCAAGTTTCA -> GCAAGTTTCAC
CGCACAACGGA -> GCACAACGGAT
CGCACCGCTTG -> GCACCGCTTGT
CGCACTAAGTG -> GCACTAAGTGA
CGCACTATTGT -> GCACTATTGTA
CGCAGATTACA -> GCAGATTACAC
CGCCAACCATG -> GCCAACCATGG
CGCCAGAGCTG -> GCCAGAGCTGT
CGCCCCAAGGT -> GCCCCAAGGTA
CGCCCTTAGCA -> GCCCTTAGCAT
CGCCGCCCTTA -> GCCGCCCTTAG
CGCCTAGTGTG -> GCCTAGTGTGG
CGCGAGAGACT -> GCGAGAGACTT
CGCGAGTGTGG -> GCGAGTGTGGG
CGCGGACACCT -> GCGGACACCTT
CGCTAGCATCA -> GCTAGCATCAC
CGCTATACATA -> GCTATACATAA
CGCTCCTTGGA -> GCTCCTTGGAC
CGCTGCTCCCC -> GCTGCTCCCCA
CGCTGGTCCAT -> GCTGGTCCATG
CGCTTGAAGTG -> GCTTGAAGTGT
CGCTTGTTTAC -> GCTTGTTTACA
CGGAACCCAAT -> GGAACCCAATA
CGGAAGAAGAG -> GGAAGAAGAGG
CGGAAGGCAGA -> GGAAGGCAGAT
CGGACACCTTA -> GGACACCTTAC
CGGACATTCGT -> GGACATTCGTC
CGGAGACTCGG -> GGAGACTCGGC
CGGAGCCGTTG -> GGAGCCGTTGT
CGGAGTGATGC -> GGAGTGATGCC
CGGAGTTGGAA -> GGAGTTGGAAT
CGGATGAGGAG -> GGATGAGGAGT
CGGATGGTAGG -> GGATGGTAGGC
CGGCATCCTAT -> GGCATCCTATA
CGGCCACTGTA -> GGCCACTGTAT
CGGCCGCACTA -> GGCCGCACTAA
CGGCCGTGATA -> GGCCGTGATAT
CGGCGGAGCCG -> GGCGGAGCCGT
CGGCGTTACTA -> GGCGTTACTAA
CGGCTGATGGG -> GGCTGATGGGG
CGGCTTAGCAC -> GGCTTAGCACT
CGGGATTGAAA -> GGGATTGAAAA
CGGGGCCCGAC -> GGGGCCCGACG
CGGTAATTGAA -> GGTAATTGAAT
CGGTCACCCTC -> GGTCACCCTCT
CGGTCGCAAGT -> GGTCGCAAGTT
CGGTGCCTGGG -> GGTGCCTGGGA
CGGTTCACGAC -> GGTTCACGACA
CGTACTAAGGT -> GTACTAAGGTG
CGTAGATAAAC -> GTAGATAAACG
CGTAGTGCGCA -> GTAGTGCGCAA
CGTCAAAATTA -> GTCAAAATTAT
CGTCAACAGAC -> GTCAACAGACG
CGTCACTTTCT -> GTCACTTTCTA
CGTCATACCAA -> GTCATACCAAC
CGTCCTCTGAT -> GTCCTCTGATG
CGTCGACGGGA -> GTCGACGGGAT
CGTCGATCTAG -> GTCGATCTAGG
CGTCGGAAGGC -> GTCGGAAGGCA
CGTCGGAGTGA -> GTCGGAGTGAT
CGTCTAGACTG -> GTCTAGACTGA
CGTCTATTTAT -> GTCTATTTATT
CGTCTGCAAGG -> GTCTGCAAGGG
CGTGATATGAT -> GTGATATGATG
CGTGATGAGAC -> GTGATGAGACG
CGTGCAAGACG -> GTGCAAGACGA
CGTGCCCGGAA -> GTGCCCGGAAG
CGTGGAGACTA -> GTGGAGACTAG
CGTGGTAACCG -> GTGGTAACCGA
CGTGTGTCTTC -> GTGTGTCTTCG
CGTTACTAACA -> GTTACTAACAC
CGTTATTATGA -> GTTATTATGAC
CGTTCGCTAGC -> GTTCGCTAGCA
CGTTCGTCGAT -> GTTCGTCGATC
CGTTCGTGCCC -> GTTCGTGCCCG
CGTTGTTAGTT -> GTTGTTAGTTA
CTAACACTAAC -> TAACACTAACA
CTAACAGTAAT -> TAACAGTAATG
CTAAGAACAGG -> TAAGAACAGGG
CTAAGGTGCCG -> TAAGGTGCCGA
CTAAGTGAAAA -> TAAGTGAAAAG
CTAATGCAATT -> TAATGCAATTA
CTAATTAACTA -> TAATTAACTAC
CTAATTGTTTA -> TAATTGTTTAA
CTACGACAGTG -> TACGACAGTGG
CTACGCCCCAA -> TACGCCCCAAG
CTACGCGAGTG -> TACGCGAGTGT
CTACGTCTGCA -> TACGTCTGCAA
CTAGACTGACT -> TAGACTGACTT
CTAGATTTTCA -> TAGATTTTCAA
CTAGCACGTGC -> TAGCACGTGCA
CTAGCAGGTGG -> TAGCAGGTGGA
CTAGCATCACA -> TAGCATCACAT
CTAGGCATCAT -> TAGGCATCATT
CTAGGCCTGGA -> TAGGCCTGGAT
CTAGTGTGGCC -> TAGTGTGGCCC
CTATACATAAA -> TATACATAAAA
CTATAGCTAGC -> TATAGCTAGCA
CTATAGTCATA -> TATAGTCATAG
CTATCTCTACG -> TATCTCTACGA
CTATGTCGCCG -> TATGTCGCCGC
CTATTAGCCAA -> TATTAGCCAAG
CTATTGAACGA -> TATTGAACGAT
CTATTGTAGGG -> TATTGTAGGGT
CTATTTATTCT -> TATTTATTCTT
CTCAGATCGGA -> TCAGATCGGAT
CTCAGCTCCTC -> TCAGCTCCTCC
CTCAGTGGACT -> TCAGTGGACTG
CTCATGAATAC -> TCATGAATACA
CTCATTGCTTT -> TCATTGCTTTT
CTCCATATCCC -> TCCATATCCCA
CTCCCCAAGAG -> TCCCCAAGAGT
CTCCCCTCTTG -> TCCCCTCTTGG
CTCCGGCTGAT -> TCCGGCTGATG
CTCCGTCGACG -> TCCGTCGACGG
CTCCGTGGAGA -> TCCGTGGAGAC
CTCCTATCTCT -> TCCTATCTCTA
CTCCTCCGGCT -> TCCTCCGGCTG
CTCCTCTGCCT -> TCCTCTGCCTG
CTCCTTGGACA -> TCCTTGGACAG
CTCGAAGAAAC -> TCGAAGAAACC
CTCGCGGACAC -> TCGCGGACACC
CTCGGCCGTGA -> TCGGCCGTGAT
CTCTACGACAG -> TCTACGACAGT
CTCTCCTATCT -> TCTCCTATCTC
CTCTGATGTTC -> TCTGATGTTCG
CTCTGCACAGA -> TCTGCACAGAC
CTCTGCCTGTC -> TCTGCCTGTCA
CTCTGTACGCA -> TCTGTACGCAC
CTCTTCGGCAT -> TCTTCGGCATC
CTCTTGGACAC -> TCTTGGACACA
CTCTTTGATGA -> TCTTTGATGAC
CTGAAAACGAA -> TGAAAACGAAT
CTGAAATTGTG -> TGAAATTGTGG
CTGAACTGCCG -> TGAACTGCCGA
CTGACCGCGAG -> TGACCGCGAGA
CTGACTTCACC -> TGACTTCACCG
CTGATGGGGTA -> TGATGGGGTAG
CTGATGTTCGG -> TGATGTTCGGT
CTGCAAGGGGG -> TGCAAGGGGGC
CTGCACAGACT -> TGCACAGACTG
CTGCCGACTTG -> TGCCGACTTGG
CTGCCTGTCAG -> TGCCTGTCAGT
CTGCTCCCCAA -> TGCTCCCCAAG
CTGCTTGACCT -> TGCTTGACCTC
CTGGATGCTTT -> TGGATGCTTTC
CTGGCTCAGCT -> TGGCTCAGCTC
CTGGGATAAGC -> TGGGATAAGCA
CTGGTAAAGAT -> TGGTAAAGATA
CTGGTCCATGA -> TGGTCCATGAG
CTGGTTGCTAA -> TGGTTGCTAAT
CTGTAAGGAAT -> TGTAAGGAATG
CTGTACGCACT -> TGTACGCACTA
CTGTATTGGAT -> TGTATTGGATA
CTGTATTTTGA -> TGTATTTTGAA
CTGTCAGTAGT -> TGTCAGTAGTG
CTGTCGCCAAC -> TGTCGCCAACC
CTTACATATTC -> TTACATATTCG
CTTACTTCATA -> TTACTTCATAC
CTTAGACCTTA -> TTAGACCTTAC
CTTAGCACTTT -> TTAGCACTTTA
CTTAGCATAGA -> TTAGCATAGAG
CTTAGCGACTA -> TTAGCGACTAG
CTTAGTTTAAA -> TTAGTTTAAAC
CTTATTTGTCG -> TTATTTGTCGA
CTTCACCGGTA -> TTCACCGGTAA
CTTCATACAAC -> TTCATACAACG
CTTCCTAGATT -> TTCCTAGATTT
CTTCGGCATCC -> TTCGGCATCCT
CTTCGGTCCTA -> TTCGGTCCTAA
CTTCGTCACTT -> TTCGTCACTTT
CTTCTCATGAA -> TTCTCATGAAT
CTTCTCTTTGA -> TTCTCTTTGAT
CTTCTGGCTCA -> TTCTGGCTCAG
CTTCTTTCATA -> TTCTTTCATAG
CTTGAAGTGTT -> TTGAAGTGTTG
CTTGACCTCGA -> TTGACCTCGAA
CTTGGACACAA -> TTGGACACAAC
CTTGGACAGTA -> TTGGACAGTAA
CTTGGCAGAAG -> TTGGCAGAAGA
CTTGGCCGCTG -> TTGGCCGCTGG
CTTGGGTATTC -> TTGGGTATTCT
CTTGTAGGAAC -> TTGTAGGAACA
CTTGTTTACAC -> TTGTTTACACC
CTTTAGCATCC -> TTTAGCATCCG
CTTTAGGACTA -> TTTAGGACTAA
CTTTATAAATC -> TTTATAAATCC
CTTTCACTTTG -> TTTCACTTTGT
CTTTCATAGCC -> TTTCATAGCCG
CTTTCTAAGAA -> TTTCTAAGAAC
CTTTGATGACC -> TTTGATGACCG
CTTTGTATCGT -> TTTGTATCGTA
CTTTTTCTTCT -> TTTTTCTTCTG
GAAAACCGTCA -> AAAACCGTCAT
GAAAACGAATC -> AAAACGAATCG
GAAAAGGGGTT -> AAAAGGGGTTC
GAAAATGGTTG -> AAAATGGTTGC
GAAACCCTCCG -> AAACCCTCCGT
GAAACCGAAGT -> AAACCGAAGTT
GAAACGTCAAC -> AAACGTCAACA
GAAACTACGCC -> AAACTACGCCC
GAAAGAATGAA -> AAAGAATGAAG
GAAATGACCCC -> AAATGACCCCT
GAAATTGTGGT -> AAATTGTGGTG
GAACACAAACC -> AACACAAACCC
GAACACAGGTA -> AACACAGGTAT
GAACACTGAAC -> AACACTGAACT
GAACAGGGGGA -> AACAGGGGGAG
GAACAGTCTCT -> AACAGTCTCTT
GAACCAACACA -> AACCAACACAC
GAACCCAATAA -> AACCCAATAAT
GAACGATCTCA -> AACGATCTCAG
GAACGATGTTG -> AACGATGTTGC
GAACTGCCGAC -> AACTGCCGACT
GAAGAAACCGA -> AAGAAACCGAA
GAAGAAGAGGG -> AAGAAGAGGGT
GAAGACGTGAT -> AAGACGTGATG
GAAGAGGGTAT -> AAGAGGGTATA
GAAGATCTATA -> AAGATCTATAG
GAAGGCAGATA -> AAGGCAGATAA
GAAGTAGAGTG -> AAGTAGAGTGA
GAAGTCTAATT -> AAGTCTAATTG
GAAGTGTTGAA -> AAGTGTTGAAA
GAAGTTCGCCT -> AAGTTCGCCTA
GAAGTTGCTCT -> AAGTTGCTCTG
GAATACAGGCT -> AATACAGGCTT
GAATAGTGAAC -> AATAGTGAACC
GAATCGTTATT -> AATCGTTATTA
GAATGAAGTTC -> AATGAAGTTCG
GAATGTTGGAC -> AATGTTGGACT
GAATTCCGAGC -> AATTCCGAGCG
GACAAAAATCG -> ACAAAAATCGG
GACAAATGAAG -> ACAAATGAAGT
GACAAGTTCCC -> ACAAGTTCCCT
GACACAACGCA -> ACACAACGCAC
GACACCTTACT -> ACACCTTACTT
GACACGCACAA -> ACACGCACAAC
GACACTCGCGG -> ACACTCGCGGA
GACAGACACTC -> ACAGACACTCG
GACAGTAACGG -> ACAGTAACGGC
GACAGTGGTGA -> ACAGTGGTGAG
GACATTCGTCT -> ACATTCGTCTA
GACCCCTATTG -> ACCCCTATTGA
GACCGCGAGAG -> ACCGCGAGAGA
GACCGGAGACT -> ACCGGAGACTC
GACCTCGAAGA -> ACCTCGAAGAA
GACCTTACATA -> ACCTTACATAT
GACCTTAGACC -> ACCTTAGACCT
GACCTTCTTTC -> ACCTTCTTTCA
GACGAAAACCG -> ACGAAAACCGT
GACGAAAGAAT -> ACGAAAGAATG
GACGACCTTAG -> ACGACCTTAGA
GACGCAGATTA -> ACGCAGATTAC
GACGGGATTGA -> ACGGGATTGAA
GACGGTTCACG -> ACGGTTCACGA
GACGTGATGAG -> ACGTGATGAGA
GACGTTCGTGC -> ACGTTCGTGCC
GACTAATGCAA -> ACTAATGCAAT
GACTAGCACGT -> ACTAGCACGTG
GACTAGGCCTG -> ACTAGGCCTGG
GACTCCATATC -> ACTCCATATCC
GACTCGGCCGT -> ACTCGGCCGTG
GACTGACCGCG -> ACTGACCGCGA
GACTGACTTCA -> ACTGACTTCAC
GACTGGTAAAG -> ACTGGTAAAGA
GACTGTCGCCA -> ACTGTCGCCAA
GACTTAGCGAC -> ACTTAGCGACT
GACTTCACCGG -> ACTTCACCGGT
GACTTGGCCGC -> ACTTGGCCGCT
GAGACGGTTCA -> AGACGGTTCAC
GAGACTAGGCC -> AGACTAGGCCT
GAGACTCCATA -> AGACTCCATAT
GAGACTCGGCC -> AGACTCGGCCG
GAGACTTAGCG -> AGACTTAGCGA
GAGAGACTTAG -> AGAGACTTAGC
GAGATAAAGCT -> AGATAAAGCTA
GAGCCAACCGG -> AGCCAACCGGT
GAGCCGTTGTT -> AGCCGTTGTTA
GAGCGTCGGAA -> AGCGTCGGAAG
GAGCTATGTCG -> AGCTATGTCGC
GAGCTCCCCTC -> AGCTCCCCTCT
GAGCTGAAAAC -> AGCTGAAAACG
GAGCTGTAAGG -> AGCTGTAAGGA
GAGCTTCTCAT -> AGCTTCTCATG
GAGCTTCTCTT -> AGCTTCTCTTT
GAGGAGTTAGG -> AGGAGTTAGGA
GAGGCCCAACG -> AGGCCCAACGC
GAGGCCTGCTT -> AGGCCTGCTTG
GAGGGTATAAC -> AGGGTATAACC
GAGGTCATCAC -> AGGTCATCACA
GAGTACACGTC -> AGTACACGTCA
GAGTGATGCCT -> AGTGATGCCTT,AGTGATGCCTG
GAGTGTGGGTG -> AGTGTGGGTGC
GAGTTAGGACG -> AGTTAGGACGT
GAGTTCATACT -> AGTTCATACTG
GAGTTGGAATA -> AGTTGGAATAG
GAGTTTACAAC -> AGTTTACAACA
GATAAACGGCG -> ATAAACGGCGG
GATAAAGCTAC -> ATAAAGCTACG
GATAAGCATTC -> ATAAGCATTCC
GATAAGGAGCT -> ATAAGGAGCTT
GATACATCTTA -> ATACATCTTAT
GATAGGCCAGT -> ATAGGCCAGTC
GATATGATGGA -> ATATGATGGAG
GATCGAACACT -> ATCGAACACTG
GATCGGATGGT -> ATCGGATGGTA
GATCTAGGCAT -> ATCTAGGCATC
GATCTATAGTC -> ATCTATAGTCA
GATCTCAGTGG -> ATCTCAGTGGA
GATGACAAAAA -> ATGACAAAAAT
GATGACCGGAG -> ATGACCGGAGA
GATGAGACGGT -> ATGAGACGGTT
GATGAGGAGTT -> ATGAGGAGTTA
GATGCCTGGTT -> ATGCCTGGTTG
GATGCCTTCCT -> ATGCCTTCCTA
GATGCTTTCAC -> ATGCTTTCACT
GATGGAGTACA -> ATGGAGTACAC
GATGGGGTAGT -> ATGGGGTAGTT
GATGGTAGGCC -> ATGGTAGGCCA
GATGGTTTTTT -> ATGGTTTTTTG
GATGTATCTTG -> ATGTATCTTGT
GATGTTCGGTC -> ATGTTCGGTCA
GATGTTGCACA -> ATGTTGCACAG
GATGTTTTGAC -> ATGTTTTGACA
GATTACACGCC -> ATTACACGCCA
GATTCCATGGG -> ATTCCATGGGT
GATTGAAAATG -> ATTGAAAATGG
GATTTCACATT -> ATTTCACATTG
GATTTCTCATT -> ATTTCTCATTG
GATTTTCAATC -> ATTTTCAATCT
GCAACAGAAAC -> CAACAGAAACT
GCAAGACGAAA -> CAAGACGAAAA
GCAAGGGGGCG -> CAAGGGGGCGT
GCAAGTTTCAC -> CAAGTTTCACA
GCAATTAAGTC -> CAATTAAGTCA
GCACAACGGAT -> CACAACGGATG
GCACAGAAGTC -> CACAGAAGTCT
GCACAGACTGG -> CACAGACTGGT
GCACCGCTTGT -> CACCGCTTGTT
GCACGTAGTGC -> CACGTAGTGCG
GCACGTGCAAG -> CACGTGCAAGA
GCACTAAGTGA -> CACTAAGTGAA
GCACTATTGTA -> CACTATTGTAG
GCACTTTAGCA -> CACTTTAGCAT
GCAGAAGACGT -> CAGAAGACGTG
GCAGATAAGGA -> CAGATAAGGAG
GCAGATTACAC -> CAGATTACACG
GCAGGAGACTC -> CAGGAGACTCC
GCAGGTGGAGG -> CAGGTGGAGGT
GCAGTGTCCAG -> CAGTGTCCAGA
GCATAGAGATA -> CATAGAGATAA
GCATCACATCT -> CATCACATCTT
GCATCATTCGG -> CATCATTCGGT
GCATCCGATGT -> CATCCGATGTA
GCATCCTATAG -> CATCCTATAGC
GCATTCCAAGC -> CATTCCAAGCA
GCCAAACAACG -> CCAAACAACGC
GCCAACCATGG -> CCAACCATGGT
GCCAACCGGTG -> CCAACCGGTGC
GCCAAGATGGT -> CCAAGATGGTT
GCCAATGGTCC -> CCAATGGTCCA
GCCACTGTATT -> CCACTGTATTG
GCCAGAGCTGT -> CCAGAGCTGTA
GCCAGTCATGT -> CCAGTCATGTC
GCCATCGTGTG -> CCATCGTGTGT
GCCCAACGCTA -> CCCAACGCTAT
GCCCAACGTAG -> CCCAACGTAGA
GCCCCAAGGTA -> CCCCAAGGTAT
GCCCGACGACC -> CCCGACGACCT
GCCCGGAAGAA -> CCCGGAAGAAG
GCCCTCCGTCG -> CCCTCCGTCGA
GCCCTTAGCAT -> CCCTTAGCATA
GCCGACTTGGC -> CCGACTTGGCC
GCCGAGCTCCC -> CCGAGCTCCCC
GCCGCACTAAG -> CCGCACTAAGT
GCCGCCCTTAG -> CCGCCCTTAGC
GCCGCTGGTCC -> CCGCTGGTCCA
GCCGTGATATG -> CCGTGATATGA
GCCGTGGTAAC -> CCGTGGTAACC
GCCGTTGTTAG -> CCGTTGTTAGT
GCCTAGTGTGG -> CCTAGTGTGGC
GCCTCCTCTGC -> CCTCCTCTGCC
GCCTGCTTGAC -> CCTGCTTGACC
GCCTGGATGCT -> CCTGGATGCTT
GCCTGGGATAA -> CCTGGGATAAG
GCCTGGTTGCT -> CCTGGTTGCTA
GCCTGTCAGTA -> CCTGTCAGTAG
GCCTTCCTAGA -> CCTTCCTAGAT
GCGACTAGCAC -> CGACTAGCACG
GCGAGAGACTT -> CGAGAGACTTA
GCGAGTGTGGG -> CGAGTGTGGGT
GCGATGTTTTG -> CGATGTTTTGA
GCGCAACAGAA -> CGCAACAGAAA
GCGGACACCTT -> CGGACACCTTA
GCGGAGCCGTT -> CGGAGCCGTTG
GCGGCCGCACT -> CGGCCGCACTA
GCGTCGGAAGG -> CGTCGGAAGGC
GCGTTACTAAC -> CGTTACTAACA
GCGTTCGTCGA -> CGTTCGTCGAT
GCTAATTAACT -> CTAATTAACTA
GCTACGTCTGC -> CTACGTCTGCA
GCTAGCAGGTG -> CTAGCAGGTGG
GCTAGCATCAC -> CTAGCATCACA
GCTATACATAA -> CTATACATAAA
GCTATGTCGCC -> CTATGTCGCCG
GCTCAGCTCCT -> CTCAGCTCCTC
GCTCCCCAAGA -> CTCCCCAAGAG
GCTCCCCTCTT -> CTCCCCTCTTG
GCTCCTCCGGC -> CTCCTCCGGCT
GCTCCTTGGAC -> CTCCTTGGACA
GCTCTGCACAG -> CTCTGCACAGA
GCTGAAAACGA -> CTGAAAACGAA
GCTGATGGGGT -> CTGATGGGGTA
GCTGCTCCCCA -> CTGCTCCCCAA
GCTGGTCCATG -> CTGGTCCATGA
GCTGTAAGGAA -> CTGTAAGGAAT
GCTGTATTTTG -> CTGTATTTTGA
GCTTAGCACTT -> CTTAGCACTTT
GCTTCTCATGA -> CTTCTCATGAA
GCTTCTCTTTG -> CTTCTCTTTGA
GCTTGAAGTGT -> CTTGAAGTGTT
GCTTGACCTCG -> CTTGACCTCGA
GCTTGTTTACA -> CTTGTTTACAC
GCTTTATAAAT -> CTTTATAAATC
GCTTTCACTTT -> CTTTCACTTTG
GCTTTTTCTTC -> CTTTTTCTTCT
GGAACACAGGT -> GAACACAGGTA
GGAACCCAATA -> GAACCCAATAA
GGAAGAAGAGG -> GAAGAAGAGGG
GGAAGGCAGAT -> GAAGGCAGATA
GGAATAGTGAA -> GAATAGTGAAC
GGAATGTTGGA -> GAATGTTGGAC
GGACAAGTTCC -> GACAAGTTCCC
GGACACAACGC -> GACACAACGCA
GGACACCTTAC -> GACACCTTACT
GGACAGTAACG -> GACAGTAACGG
GGACATTCGTC -> GACATTCGTCT
GGACGTTCGTG -> GACGTTCGTGC
GGACTAATGCA -> GACTAATGCAA
GGACTGACCGC -> GACTGACCGCG
GGACTGTCGCC -> GACTGTCGCCA
GGAGACTAGGC -> GAGACTAGGCC
GGAGACTCCAT -> GAGACTCCATA
GGAGACTCGGC -> GAGACTCGGCC
GGAGCCGTTGT -> GAGCCGTTGTT
GGAGCTGAAAA -> GAGCTGAAAAC
GGAGCTTCTCA -> GAGCTTCTCAT
GGAGGTCATCA -> GAGGTCATCAC
GGAGTACACGT -> GAGTACACGTC
GGAGTGATGCC -> GAGTGATGCCT
GGAGTTAGGAC -> GAGTTAGGACG
GGAGTTGGAAT -> GAGTTGGAATA
GGATAAGCATT -> GATAAGCATTC
GGATACATCTT -> GATACATCTTA
GGATGAGGAGT -> GATGAGGAGTT
GGATGCTTTCA -> GATGCTTTCAC
GGATGGTAGGC -> GATGGTAGGCC
GGATTGAAAAT -> GATTGAAAATG
GGCAGAAGACG -> GCAGAAGACGT
GGCAGATAAGG -> GCAGATAAGGA
GGCAGGAGACT -> GCAGGAGACTC
GGCATCATTCG -> GCATCATTCGG
GGCATCCTATA -> GCATCCTATAG
GGCCAAACAAC -> GCCAAACAACG
GGCCACTGTAT -> GCCACTGTATT
GGCCAGTCATG -> GCCAGTCATGT
GGCCATCGTGT -> GCCATCGTGTG
GGCCCAACGCT -> GCCCAACGCTA
GGCCCGACGAC -> GCCCGACGACC
GGCCCTCCGTC -> GCCCTCCGTCG
GGCCGCACTAA -> GCCGCACTAAG
GGCCGCTGGTC -> GCCGCTGGTCC
GGCCGTGATAT -> GCCGTGATATG
GGCCTCCTCTG -> GCCTCCTCTGC
GGCCTGCTTGA -> GCCTGCTTGAC
GGCCTGGATGC -> GCCTGGATGCT
GGCGGAGCCGT -> GCGGAGCCGTT
GGCGGCCGCAC -> GCGGCCGCACT
GGCGTTACTAA -> GCGTTACTAAC
GGCGTTCGTCG -> GCGTTCGTCGA
GGCTCAGCTCC -> GCTCAGCTCCT
GGCTGATGGGG -> GCTGATGGGGT
GGCTTAGCACT -> GCTTAGCACTT
GGCTTTATAAA -> GCTTTATAAAT
GGGAGCTGAAA -> GGAGCTGAAAA
GGGATAAGCAT -> GGATAAGCATT
GGGATTGAAAA -> GGATTGAAAAT
GGGCAGGAGAC -> GGCAGGAGACT
GGGCCAAACAA -> GGCCAAACAAC
GGGCCCGACGA -> GGCCCGACGAC
GGGCCTCCTCT -> GGCCTCCTCTG
GGGCGGCCGCA -> GGCGGCCGCAC
GGGCGTTCGTC -> GGCGTTCGTCG
GGGGAGCTGAA -> GGGAGCTGAAA
GGGGCCAAACA -> GGGCCAAACAA
GGGGCCCGACG -> GGGCCCGACGA
GGGGCCTCCTC -> GGGCCTCCTCT
GGGGCGTTCGT -> GGGCGTTCGTC
GGGGGAGCTGA -> GGGGAGCTGAA
GGGGGCCAAAC -> GGGGCCAAACA
GGGGGCGTTCG -> GGGGCGTTCGT
GGGGTAGTTAG -> GGGTAGTTAGT
GGGGTTCGCTG -> GGGTTCGCTGC
GGGTAAGTAAA -> GGTAAGTAAAC
GGGTAGTTAGT -> GGTAGTTAGTC
GGGTATAACCT -> GGTATAACCTC
GGGTATTCTCT -> GGTATTCTCTC
GGGTCCGTCCT -> GGTCCGTCCTC
GGGTGCTGTAT -> GGTGCTGTATT
GGGTTCGCTGC -> GGTTCGCTGCT
GGTAAAGATAG -> GTAAAGATAGG
GGTAACCGAGT -> GTAACCGAGTT
GGTAAGTAAAC -> GTAAGTAAACC
GGTAATTGAAT -> GTAATTGAATT
GGTAGCAGTGT -> GTAGCAGTGTC
GGTAGGCCATC -> GTAGGCCATCG
GGTAGTTAGTC -> GTAGTTAGTCA
GGTATAACCTC -> GTATAACCTCA
GGTATGATTTC -> GTATGATTTCT
GGTATGGGCGG -> GTATGGGCGGC
GGTATTCTCTC -> GTATTCTCTCC
GGTCACCCTCT -> GTCACCCTCTG
GGTCATCACAT -> GTCATCACATG
GGTCCACGGCT -> GTCCACGGCTT
GGTCCATGAGG -> GTCCATGAGGC
GGTCCGTCCTC -> GTCCGTCCTCT
GGTCGCAAGTT -> GTCGCAAGTTT
GGTGAGCTATG -> GTGAGCTATGT
GGTGCCGAGCT -> GTGCCGAGCTC
GGTGCCTGGGA -> GTGCCTGGGAT
GGTGCTGTATT -> GTGCTGTATTT
GGTGGACAAGT -> GTGGACAAGTT
GGTGGAGGTCA -> GTGGAGGTCAT
GGTTCACGACA -> GTTCACGACAA
GGTTCGCTGCT -> GTTCGCTGCTC
GGTTCGTCGGA -> GTTCGTCGGAG
GGTTGCCAATG -> GTTGCCAATGG
GGTTGCTAATT -> GTTGCTAATTA
GGTTTTTTGGG -> GTTTTTTGGGC
GTAAACCAGAA -> TAAACCAGAAC
GTAAAGATAGG -> TAAAGATAGGC
GTAACCGAGTT -> TAACCGAGTTC
GTAACGGACAT -> TAACGGACATT
GTAACGGCGTT -> TAACGGCGTTA
GTAAGGAATGT -> TAAGGAATGTT
GTAAGTAAACC -> TAAGTAAACCA
GTAATGAGCCA -> TAATGAGCCAA
GTAATTGAATT -> TAATTGAATTC
GTACACGTCAA -> TACACGTCAAA
GTACGCACTAT -> TACGCACTATT
GTACTAAGGTG -> TACTAAGGTGC
GTAGAGTGATG -> TAGAGTGATGC
GTAGATAAACG -> TAGATAAACGG
GTAGCAGTGTC -> TAGCAGTGTCC
GTAGGAACACA -> TAGGAACACAG
GTAGGCCATCG -> TAGGCCATCGT
GTAGGGTAAGT -> TAGGGTAAGTA
GTAGTGCGCAA -> TAGTGCGCAAC
GTAGTGTTGCG -> TAGTGTTGCGA
GTAGTTAGTCA -> TAGTTAGTCAT
GTATAACCTCA -> TATAACCTCAG
GTATCGTACTA -> TATCGTACTAA
GTATCTTGTAG -> TATCTTGTAGG
GTATGATTTCT -> TATGATTTCTC
GTATGGGCGGC -> TATGGGCGGCC
GTATTCTCTCC -> TATTCTCTCCT
GTATTGGATAC -> TATTGGATACA
GTATTTTGAAC -> TATTTTGAACA
GTCAAAATTAT -> TCAAAATTATT
GTCAACAGACG -> TCAACAGACGC
GTCACAACGGA -> TCACAACGGAG
GTCACCCTCTG -> TCACCCTCTGT
GTCACTTTCTA -> TCACTTTCTAA
GTCAGTAGTGT -> TCAGTAGTGTT
GTCATACCAAC -> TCATACCAACG
GTCATAGAAAC -> TCATAGAAACG
GTCATATTGTT -> TCATATTGTTT
GTCATCACATG -> TCATCACATGC
GTCATGTCGAG -> TCATGTCGAGC
GTCCACGGCTT -> TCCACGGCTTA
GTCCAGATTCC -> TCCAGATTCCA
GTCCATGAGGC -> TCCATGAGGCC
GTCCGTCCTCT -> TCCGTCCTCTG
GTCCTCTGATG -> TCCTCTGATGT
GTCGACGGGAT -> TCGACGGGATT
GTCGAGCTTCT -> TCGAGCTTCTC
GTCGATCTAGG -> TCGATCTAGGC
GTCGATGACAA -> TCGATGACAAA
GTCGCAAGTTT -> TCGCAAGTTTC
GTCGCCAACCA -> TCGCCAACCAT
GTCGCCGCCCT -> TCGCCGCCCTT
GTCGGAAGGCA -> TCGGAAGGCAG
GTCGGAGTGAT -> TCGGAGTGATG
GTCTAATTGTT -> TCTAATTGTTT
GTCTAGACTGA -> TCTAGACTGAC
GTCTATTTATT -> TCTATTTATTC
GTCTCTTCGGC -> TCTCTTCGGCA
GTCTGCAAGGG -> TCTGCAAGGGG
GTCTTCGGTCC -> TCTTCGGTCCT
GTGAAAAGGGG -> TGAAAAGGGGT
GTGAACCAACA -> TGAACCAACAC
GTGAGCTATGT -> TGAGCTATGTC
GTGATATGATG -> TGATATGATGG
GTGATGAGACG -> TGATGAGACGG
GTGATGCCTGG -> TGATGCCTGGT
GTGATGCCTTC -> TGATGCCTTCC
GTGCAAGACGA -> TGCAAGACGAA
GTGCCCGGAAG -> TGCCCGGAAGA
GTGCCGAGCTC -> TGCCGAGCTCC
GTGCCTGGGAT -> TGCCTGGGATA
GTGCGCAACAG -> TGCGCAACAGA
GTGCTGTATTT -> TGCTGTATTTT
GTGGACAAGTT -> TGGACAAGTTC
GTGGACTGACC -> TGGACTGACCG
GTGGAGACTAG -> TGGAGACTAGG
GTGGAGGTCAT -> TGGAGGTCATC
GTGGCCCTCCG -> TGGCCCTCCGT
GTGGGTGCTGT -> TGGGTGCTGTA
GTGGTAACCGA -> TGGTAACCGAG
GTGGTGAGCTA -> TGGTGAGCTAT
GTGGTGGACAA -> TGGTGGACAAG
GTGTCCAGATT -> TGTCCAGATTC
GTGTCTTCGGT -> TGTCTTCGGTC
GTGTGGCCCTC -> TGTGGCCCTCC
GTGTGGGTGCT -> TGTGGGTGCTG
GTGTGTCTTCG -> TGTGTCTTCGG
GTGTTGAAATG -> TGTTGAAATGA
GTGTTGCGATG -> TGTTGCGATGT
GTTAATGGTTC -> TTAATGGTTCG
GTTACTAACAC -> TTACTAACACT
GTTAGGACGTT -> TTAGGACGTTC
GTTAGTCATAT -> TTAGTCATATT
GTTAGTTAATG -> TTAGTTAATGG
GTTATTATGAC -> TTATTATGACC
GTTCACGACAA -> TTCACGACAAA
GTTCATACTGA -> TTCATACTGAA
GTTCCCTTGGC -> TTCCCTTGGCA
GTTCGCCTAGT -> TTCGCCTAGTG
GTTCGCTAGCA -> TTCGCTAGCAT
GTTCGCTGCTC -> TTCGCTGCTCC
GTTCGGTCACC -> TTCGGTCACCC
GTTCGTCGATC -> TTCGTCGATCT
GTTCGTCGGAG -> TTCGTCGGAGT
GTTCGTGCCCG -> TTCGTGCCCGG
GTTGAAATGAC -> TTGAAATGACC
GTTGCACAGAA -> TTGCACAGAAG
GTTGCCAATGG -> TTGCCAATGGT
GTTGCGATGTT -> TTGCGATGTTT
GTTGCTAATTA -> TTGCTAATTAA
GTTGCTCTGCA -> TTGCTCTGCAC
GTTGGAATAGT -> TTGGAATAGTG
GTTGGACTGTC -> TTGGACTGTCG
GTTGTTAGTTA -> TTGTTAGTTAA
GTTTAAACGAA -> TTTAAACGAAC
GTTTAAACTTT -> TTTAAACTTTA
GTTTACAACAC -> TTTACAACACC
GTTTACACCGG -> TTTACACCGGG
GTTTCACATTC -> TTTCACATTCC
GTTTTCACATT -> TTTTCACATTT
GTTTTGACACG -> TTTTGACACGC
GTTTTTTGGGC -> TTTTTTGGGCA
TAAAATATCGT -> AAAATATCGTT
TAAACCAGAAC -> AAACCAGAACG
TAAACGAACAG -> AAACGAACAGT
TAAACGGCGGA -> AAACGGCGGAG
TAAACTTTAGG -> AAACTTTAGGA
TAAAGATAGGC -> AAAGATAGGCC
TAAAGCTACGT -> AAAGCTACGTC
TAAATCCCGGC -> AAATCCCGGCC
TAACACTAACA -> AACACTAACAG
TAACAGTAATG -> AACAGTAATGA
TAACCGAGTTC -> AACCGAGTTCA
TAACCTCAGAT -> AACCTCAGATC
TAACGGACATT -> AACGGACATTC
TAACGGCGTTA -> AACGGCGTTAC
TAACTACGCGA -> AACTACGCGAG
TAAGAACAGGG -> AAGAACAGGGG
TAAGCATTCCA -> AAGCATTCCAA
TAAGGAATGTT -> AAGGAATGTTG
TAAGGAGCTTC -> AAGGAGCTTCT
TAAGGTGCCGA -> AAGGTGCCGAG
TAAGTAAACCA -> AAGTAAACCAG
TAAGTCACAAC -> AAGTCACAACG
TAAGTGAAAAG -> AAGTGAAAAGG
TAATGAGCCAA -> AATGAGCCAAC
TAATGCAATTA -> AATGCAATTAA
TAATGGTTCGT -> AATGGTTCGTC
TAATTAACTAC -> AATTAACTACG
TAATTAATTGT -> AATTAATTGTA
TAATTGAATTC -> AATTGAATTCC
TAATTGTAACG -> AATTGTAACGG
TAATTGTTTAA -> AATTGTTTAAA
TACAACACCGA -> ACAACACCGAA
TACAACGTCTA -> ACAACGTCTAG
TACACCGGGGC -> ACACCGGGGCC
TACACGCCAGA -> ACACGCCAGAG
TACACGTCAAA -> ACACGTCAAAA
TACAGGCTTTA -> ACAGGCTTTAT
TACATAAAATA -> ACATAAAATAT
TACATATTCGA -> ACATATTCGAG
TACATCTTATT -> ACATCTTATTT
TACCAACGACG -> ACCAACGACGA
TACCGATCGAA -> ACCGATCGAAC
TACGACAGTGG -> ACGACAGTGGT
TACGCACTATT -> ACGCACTATTG
TACGCCCCAAG -> ACGCCCCAAGG
TACGCGAGTGT -> ACGCGAGTGTG
TACGTCTGCAA -> ACGTCTGCAAG
TACTAACACTA -> ACTAACACTAA
TACTAAGGTGC -> ACTAAGGTGCC
TACTGAAATTG -> ACTGAAATTGT
TACTTCATACA -> ACTTCATACAA
TAGAAACGTCA -> AGAAACGTCAA
TAGACCTTACA -> AGACCTTACAT
TAGACTGACTT -> AGACTGACTTC
TAGAGATAAAG -> AGAGATAAAGC
TAGAGTGATGC -> AGAGTGATGCC
TAGATAAACGG -> AGATAAACGGC
TAGATTTTCAA -> AGATTTTCAAT
TAGCACGTGCA -> AGCACGTGCAA
TAGCACTTTAG -> AGCACTTTAGC
TAGCAGGTGGA -> AGCAGGTGGAG
TAGCAGTGTCC -> AGCAGTGTCCA
TAGCATAGAGA -> AGCATAGAGAT
TAGCATCACAT -> AGCATCACATC
TAGCATCCGAT -> AGCATCCGATG
TAGCCAAGATG -> AGCCAAGATGG
TAGCCGTGGTA -> AGCCGTGGTAA
TAGCGACTAGC -> AGCGACTAGCA
TAGCTAGCAGG -> AGCTAGCAGGT
TAGGAACACAG -> AGGAACACAGG
TAGGACGTTCG -> AGGACGTTCGT
TAGGACTAATG -> AGGACTAATGC
TAGGCATCATT -> AGGCATCATTC
TAGGCCAGTCA -> AGGCCAGTCAT
TAGGCCATCGT -> AGGCCATCGTG
TAGGCCTGGAT -> AGGCCTGGATG
TAGGGTAAGTA -> AGGGTAAGTAA
TAGTCATAGAA -> AGTCATAGAAA
TAGTCATATTG -> AGTCATATTGT
TAGTGAACCAA -> AGTGAACCAAC
TAGTGCGCAAC -> AGTGCGCAACA
TAGTGTGGCCC -> AGTGTGGCCCT
TAGTGTTGCGA -> AGTGTTGCGAT
TAGTTAATGGT -> AGTTAATGGTT
TAGTTAGTCAT -> AGTTAGTCATA
TAGTTTAAACG -> AGTTTAAACGA
TATAAATCCCG -> ATAAATCCCGG
TATAACCTCAG -> ATAACCTCAGA
TATACATAAAA -> ATACATAAAAT
TATAGCTAGCA -> ATAGCTAGCAG
TATAGTCATAG -> ATAGTCATAGA
TATCCCAATAC -> ATCCCAATACC
TATCGTACTAA -> ATCGTACTAAG
TATCGTTCGCT -> ATCGTTCGCTA
TATCTCTACGA -> ATCTCTACGAC
TATCTTGTAGG -> ATCTTGTAGGA
TATGACCTTCT -> ATGACCTTCTT
TATGATGGAGT -> ATGATGGAGTA
TATGATTTCTC -> ATGATTTCTCA
TATGGGCGGCC -> ATGGGCGGCCG
TATGTCGCCGC -> ATGTCGCCGCC
TATTAGCCAAG -> ATTAGCCAAGA
TATTATGACCT -> ATTATGACCTT
TATTCGACAGA -> ATTCGACAGAC
TATTCGAGGCC -> ATTCGAGGCCT
TATTCTCTCCT -> ATTCTCTCCTA
TATTCTTAGTT -> ATTCTTAGTTT
TATTGAACGAT -> ATTGAACGATC
TATTGGATACA -> ATTGGATACAT
TATTGTAGGGT -> ATTGTAGGGTA
TATTGTTTTCA -> ATTGTTTTCAC
TATTTATTCTT -> ATTTATTCTTA
TATTTGTCGAT -> ATTTGTCGATG
TATTTTGAACA -> ATTTTGAACAC
TCAAAATTATT -> CAAAATTATTC
TCAACAGACGC -> CAACAGACGCA
TCAATCTTGGG -> CAATCTTGGGT
TCACAACGGAG -> CACAACGGAGT
TCACATCTTCG -> CACATCTTCGT
TCACATGCCCA -> CACATGCCCAA
TCACATTCCTA -> CACATTCCTAT
TCACATTGGGG -> CACATTGGGGC
TCACATTTTGG -> CACATTTTGGG
TCACCCTCTGT -> CACCCTCTGTA
TCACCGGTAAT -> CACCGGTAATT
TCACGACAAAT -> CACGACAAATG
TCACTTTCTAA -> CACTTTCTAAG
TCACTTTGTAT -> CACTTTGTATC
TCAGATCGGAT -> CAGATCGGATG
TCAGCTCCTCC -> CAGCTCCTCCG
TCAGTAGTGTT -> CAGTAGTGTTG
TCAGTGGACTG -> CAGTGGACTGA
TCATACAACGT -> CATACAACGTC
TCATACCAACG -> CATACCAACGA
TCATACTGAAA -> CATACTGAAAT
TCATAGAAACG -> CATAGAAACGT
TCATAGCCGTG -> CATAGCCGTGG
TCATATTGTTT -> CATATTGTTTT
TCATCACATGC -> CATCACATGCC
TCATGAATACA -> CATGAATACAG
TCATGTCGAGC -> CATGTCGAGCT
TCATTCGGTCG -> CATTCGGTCGC
TCATTGCTTTT -> CATTGCTTTTT
TCCAAGCACGT -> CCAAGCACGTA
TCCACGGCTTA -> CCACGGCTTAG
TCCAGATTCCA -> CCAGATTCCAT
TCCATATCCCA -> CCATATCCCAA
TCCATGAGGCC -> CCATGAGGCCC
TCCATGGGTCC -> CCATGGGTCCG
TCCCAATACCG -> CCCAATACCGA
TCCCCAAGAGT -> CCCCAAGAGTT
TCCCCTCTTGG -> CCCCTCTTGGA
TCCCGGCCACT -> CCCGGCCACTG
TCCCTTGGCAG -> CCCTTGGCAGA
TCCGAGCGTCG -> CCGAGCGTCGG
TCCGATGTATC -> CCGATGTATCT
TCCGGCTGATG -> CCGGCTGATGG
TCCGTCCTCTG -> CCGTCCTCTGA
TCCGTCGACGG -> CCGTCGACGGG
TCCGTGGAGAC -> CCGTGGAGACT
TCCTAGATTTT -> CCTAGATTTTC
TCCTATAGCTA -> CCTATAGCTAG
TCCTATCTCTA -> CCTATCTCTAC
TCCTATTAGCC -> CCTATTAGCCA
TCCTCCGGCTG -> CCTCCGGCTGA
TCCTCTGATGT -> CCTCTGATGTT
TCCTCTGCCTG -> CCTCTGCCTGT
TCCTTGGACAG -> CCTTGGACAGT
TCGAACACTGA -> CGAACACTGAA
TCGAAGAAACC -> CGAAGAAACCG
TCGACAGACAC -> CGACAGACACT
TCGACGGGATT -> CGACGGGATTG
TCGAGCTTCTC -> CGAGCTTCTCT
TCGAGGCCTGC -> CGAGGCCTGCT
TCGATCTAGGC -> CGATCTAGGCA
TCGATGACAAA -> CGATGACAAAA
TCGCAAGTTTC -> CGCAAGTTTCA
TCGCCAACCAT -> CGCCAACCATG
TCGCCGCCCTT -> CGCCGCCCTTA
TCGCCTAGTGT -> CGCCTAGTGTG
TCGCGGACACC -> CGCGGACACCT
TCGCTAGCATC -> CGCTAGCATCA
TCGCTGCTCCC -> CGCTGCTCCCC
TCGGAACCCAA -> CGGAACCCAAT
TCGGAAGGCAG -> CGGAAGGCAGA
TCGGAGTGATG -> CGGAGTGATGC
TCGGATGGTAG -> CGGATGGTAGG
TCGGCATCCTA -> CGGCATCCTAT
TCGGCCGTGAT -> CGGCCGTGATA
TCGGTCACCCT -> CGGTCACCCTC
TCGGTCGCAAG -> CGGTCGCAAGT
TCGTACTAAGG -> CGTACTAAGGT
TCGTCACTTTC -> CGTCACTTTCT
TCGTCGATCTA -> CGTCGATCTAG
TCGTCGGAGTG -> CGTCGGAGTGA
TCGTCTATTTA -> CGTCTATTTAT
TCGTGCCCGGA -> CGTGCCCGGAA
TCGTGTGTCTT -> CGTGTGTCTTC
TCGTTATTATG -> CGTTATTATGA
TCGTTCGCTAG -> CGTTCGCTAGC
TCTAAGAACAG -> CTAAGAACAGG
TCTAATTGTTT -> CTAATTGTTTA
TCTACGACAGT -> CTACGACAGTG
TCTAGACTGAC -> CTAGACTGACT
TCTAGGCATCA -> CTAGGCATCAT
TCTATAGTCAT -> CTATAGTCATA
TCTATTTATTC -> CTATTTATTCT
TCTCAGTGGAC -> CTCAGTGGACT
TCTCATGAATA -> CTCATGAATAC
TCTCATTGCTT -> CTCATTGCTTT
TCTCCTATCTC -> CTCCTATCTCT
TCTCTACGACA -> CTCTACGACAG
TCTCTCCTATC -> CTCTCCTATCT
TCTCTTCGGCA -> CTCTTCGGCAT
TCTCTTTGATG -> CTCTTTGATGA
TCTGATGTTCG -> CTGATGTTCGG
TCTGCAAGGGG -> CTGCAAGGGGG
TCTGCACAGAC -> CTGCACAGACT
TCTGCCTGTCA -> CTGCCTGTCAG
TCTGGCTCAGC -> CTGGCTCAGCT
TCTGTACGCAC -> CTGTACGCACT
TCTTAGTTTAA -> CTTAGTTTAAA
TCTTATTTGTC -> CTTATTTGTCG
TCTTCGGCATC -> CTTCGGCATCC
TCTTCGGTCCT -> CTTCGGTCCTA
TCTTCGTCACT -> CTTCGTCACTT
TCTTCTGGCTC -> CTTCTGGCTCA
TCTTGGACACA -> CTTGGACACAA
TCTTGGGTATT -> CTTGGGTATTC
TCTTGTAGGAA -> CTTGTAGGAAC
TCTTTCATAGC -> CTTTCATAGCC
TCTTTGATGAC -> CTTTGATGACC
TGAAAACGAAT -> GAAAACGAATC
TGAAAAGGGGT -> GAAAAGGGGTT
TGAAAATGGTT -> GAAAATGGTTG
TGAAATGACCC -> GAAATGACCCC
TGAAATTGTGG -> GAAATTGTGGT
TGAACACAAAC -> GAACACAAACC
TGAACCAACAC -> GAACCAACACA
TGAACGATCTC -> GAACGATCTCA
TGAACTGCCGA -> GAACTGCCGAC
TGAAGTAGAGT -> GAAGTAGAGTG
TGAAGTGTTGA -> GAAGTGTTGAA
TGAAGTTCGCC -> GAAGTTCGCCT
TGAATACAGGC -> GAATACAGGCT
TGAATTCCGAG -> GAATTCCGAGC
TGACAAAAATC -> GACAAAAATCG
TGACACGCACA -> GACACGCACAA
TGACCCCTATT -> GACCCCTATTG
TGACCGCGAGA -> GACCGCGAGAG
TGACCGGAGAC -> GACCGGAGACT
TGACCTCGAAG -> GACCTCGAAGA
TGACCTTCTTT -> GACCTTCTTTC
TGACTTCACCG -> GACTTCACCGG
TGAGACGGTTC -> GAGACGGTTCA
TGAGCCAACCG -> GAGCCAACCGG
TGAGCTATGTC -> GAGCTATGTCG
TGAGGAGTTAG -> GAGGAGTTAGG
TGAGGCCCAAC -> GAGGCCCAACG
TGATATGATGG -> GATATGATGGA
TGATGACCGGA -> GATGACCGGAG
TGATGAGACGG -> GATGAGACGGT
TGATGCCTGGT -> GATGCCTGGTT
TGATGCCTTCC -> GATGCCTTCCT
TGATGGAGTAC -> GATGGAGTACA
TGATGGGGTAG -> GATGGGGTAGT
TGATGTTCGGT -> GATGTTCGGTC
TGATTTCTCAT -> GATTTCTCATT
TGCAAGACGAA -> GCAAGACGAAA
TGCAAGGGGGC -> GCAAGGGGGCG
TGCAATTAAGT -> GCAATTAAGTC
TGCACAGAAGT -> GCACAGAAGTC
TGCACAGACTG -> GCACAGACTGG
TGCCAATGGTC -> GCCAATGGTCC
TGCCCAACGTA -> GCCCAACGTAG
TGCCCGGAAGA -> GCCCGGAAGAA
TGCCGACTTGG -> GCCGACTTGGC
TGCCGAGCTCC -> GCCGAGCTCCC
TGCCTGGGATA -> GCCTGGGATAA
TGCCTGGTTGC -> GCCTGGTTGCT
TGCCTGTCAGT -> GCCTGTCAGTA
TGCCTTCCTAG -> GCCTTCCTAGA
TGCGATGTTTT -> GCGATGTTTTG
TGCGCAACAGA -> GCGCAACAGAA
TGCTAATTAAC -> GCTAATTAACT
TGCTCCCCAAG -> GCTCCCCAAGA
TGCTCTGCACA -> GCTCTGCACAG
TGCTGTATTTT -> GCTGTATTTTG
TGCTTGACCTC -> GCTTGACCTCG
TGCTTTCACTT -> GCTTTCACTTT
TGCTTTTTCTT -> GCTTTTTCTTC
TGGAATAGTGA -> GGAATAGTGAA
TGGACAAGTTC -> GGACAAGTTCC
TGGACACAACG -> GGACACAACGC
TGGACAGTAAC -> GGACAGTAACG
TGGACTGACCG -> GGACTGACCGC
TGGACTGTCGC -> GGACTGTCGCC
TGGAGACTAGG -> GGAGACTAGGC
TGGAGGTCATC -> GGAGGTCATCA
TGGAGTACACG -> GGAGTACACGT
TGGATACATCT -> GGATACATCTT
TGGATGCTTTC -> GGATGCTTTCA
TGGCAGAAGAC -> GGCAGAAGACG
TGGCCCTCCGT -> GGCCCTCCGTC
TGGCCGCTGGT -> GGCCGCTGGTC
TGGCTCAGCTC -> GGCTCAGCTCC
TGGGATAAGCA -> GGGATAAGCAT
TGGGCAGGAGA -> GGGCAGGAGAC
TGGGCGGCCGC -> GGGCGGCCGCA
TGGGGCCTCCT -> GGGGCCTCCTC
TGGGGGCCAAA -> GGGGGCCAAAC
TGGGGTAGTTA -> GGGGTAGTTAG
TGGGTATTCTC -> GGGTATTCTCT
TGGGTCCGTCC -> GGGTCCGTCCT
TGGGTGCTGTA -> GGGTGCTGTAT
TGGTAAAGATA -> GGTAAAGATAG
TGGTAACCGAG -> GGTAACCGAGT
TGGTAGCAGTG -> GGTAGCAGTGT
TGGTAGGCCAT -> GGTAGGCCATC
TGGTCCACGGC -> GGTCCACGGCT
TGGTCCATGAG -> GGTCCATGAGG
TGGTGAGCTAT -> GGTGAGCTATG
TGGTGGACAAG -> GGTGGACAAGT
TGGTTCGTCGG -> GGTTCGTCGGA
TGGTTGCCAAT -> GGTTGCCAATG
TGGTTGCTAAT -> GGTTGCTAATT
TGGTTTTTTGG -> GGTTTTTTGGG
TGTAACGGACA -> GTAACGGACAT
TGTAAGGAATG -> GTAAGGAATGT
TGTACGCACTA -> GTACGCACTAT
TGTAGGAACAC -> GTAGGAACACA
TGTAGGGTAAG -> GTAGGGTAAGT
TGTATCGTACT -> GTATCGTACTA
TGTATCTTGTA -> GTATCTTGTAG
TGTATTGGATA -> GTATTGGATAC
TGTATTTTGAA -> GTATTTTGAAC
TGTCAGTAGTG -> GTCAGTAGTGT
TGTCCAGATTC -> GTCCAGATTCC
TGTCGAGCTTC -> GTCGAGCTTCT
TGTCGATGACA -> GTCGATGACAA
TGTCGCCAACC -> GTCGCCAACCA
TGTCGCCGCCC -> GTCGCCGCCCT
TGTCTTCGGTC -> GTCTTCGGTCC
TGTGGCCCTCC -> GTGGCCCTCCG
TGTGGGTGCTG -> GTGGGTGCTGT
TGTGGTGGACA -> GTGGTGGACAA
TGTGTCTTCGG -> GTGTCTTCGGT
TGTTAGTTAAT -> GTTAGTTAATG
TGTTCGGTCAC -> GTTCGGTCACC
TGTTGAAATGA -> GTTGAAATGAC
TGTTGCACAGA -> GTTGCACAGAA
TGTTGCGATGT -> GTTGCGATGTT
TGTTGGACTGT -> GTTGGACTGTC
TGTTTAAACTT -> GTTTAAACTTT
TGTTTACACCG -> GTTTACACCGG
TGTTTTCACAT -> GTTTTCACATT
TGTTTTGACAC -> GTTTTGACACG
TTAAACGAACA -> TAAACGAACAG
TTAAACTTTAG -> TAAACTTTAGG
TTAACTACGCG -> TAACTACGCGA
TTAAGTCACAA -> TAAGTCACAAC
TTAATGGTTCG -> TAATGGTTCGT
TTAATTGTAAC -> TAATTGTAACG
TTACAACACCG -> TACAACACCGA
TTACACCGGGG -> TACACCGGGGC
TTACACGCCAG -> TACACGCCAGA
TTACATATTCG -> TACATATTCGA
TTACTAACACT -> TACTAACACTA
TTACTTCATAC -> TACTTCATACA
TTAGACCTTAC -> TAGACCTTACA
TTAGCACTTTA -> TAGCACTTTAG
TTAGCATAGAG -> TAGCATAGAGA
TTAGCATCCGA -> TAGCATCCGAT
TTAGCCAAGAT -> TAGCCAAGATG
TTAGCGACTAG -> TAGCGACTAGC
TTAGGACGTTC -> TAGGACGTTCG
TTAGGACTAAT -> TAGGACTAATG
TTAGTCATATT -> TAGTCATATTG
TTAGTTAATGG -> TAGTTAATGGT
TTAGTTTAAAC -> TAGTTTAAACG
TTATAAATCCC -> TATAAATCCCG
TTATGACCTTC -> TATGACCTTCT
TTATTATGACC -> TATTATGACCT
TTATTCGACAG -> TATTCGACAGA
TTATTCTTAGT -> TATTCTTAGTT
TTATTTGTCGA -> TATTTGTCGAT
TTCAATCTTGG -> TCAATCTTGGG
TTCACATTCCT -> TCACATTCCTA
TTCACATTGGG -> TCACATTGGGG
TTCACATTTTG -> TCACATTTTGG
TTCACCGGTAA -> TCACCGGTAAT
TTCACGACAAA -> TCACGACAAAT
TTCACTTTGTA -> TCACTTTGTAT
TTCATACAACG -> TCATACAACGT
TTCATACTGAA -> TCATACTGAAA
TTCATAGCCGT -> TCATAGCCGTG
TTCCAAGCACG -> TCCAAGCACGT
TTCCATGGGTC -> TCCATGGGTCC
TTCCCTTGGCA -> TCCCTTGGCAG
TTCCGAGCGTC -> TCCGAGCGTCG
TTCCTAGATTT -> TCCTAGATTTT
TTCCTATTAGC -> TCCTATTAGCC
TTCGACAGACA -> TCGACAGACAC
TTCGAGGCCTG -> TCGAGGCCTGC
TTCGCCTAGTG -> TCGCCTAGTGT
TTCGCTAGCAT -> TCGCTAGCATC
TTCGCTGCTCC -> TCGCTGCTCCC
TTCGGCATCCT -> TCGGCATCCTA
TTCGGTCACCC -> TCGGTCACCCT
TTCGGTCGCAA -> TCGGTCGCAAG
TTCGTCACTTT -> TCGTCACTTTC
TTCGTCGATCT -> TCGTCGATCTA
TTCGTCGGAGT -> TCGTCGGAGTG
TTCGTCTATTT -> TCGTCTATTTA
TTCGTGCCCGG -> TCGTGCCCGGA
TTCTAAGAACA -> TCTAAGAACAG
TTCTCATGAAT -> TCTCATGAATA
TTCTCATTGCT -> TCTCATTGCTT
TTCTCTCCTAT -> TCTCTCCTATC
TTCTCTTTGAT -> TCTCTTTGATG
TTCTGGCTCAG -> TCTGGCTCAGC
TTCTTAGTTTA -> TCTTAGTTTAA
TTCTTCTGGCT -> TCTTCTGGCTC
TTCTTTCATAG -> TCTTTCATAGC
TTGAAAATGGT -> TGAAAATGGTT
TTGAAATGACC -> TGAAATGACCC
TTGAACACAAA -> TGAACACAAAC
TTGAACGATCT -> TGAACGATCTC
TTGAAGTGTTG -> TGAAGTGTTGA
TTGAATTCCGA -> TGAATTCCGAG
TTGACACGCAC -> TGACACGCACA
TTGACCTCGAA -> TGACCTCGAAG
TTGATGACCGG -> TGATGACCGGA
TTGCACAGAAG -> TGCACAGAAGT
TTGCCAATGGT -> TGCCAATGGTC
TTGCGATGTTT -> TGCGATGTTTT
TTGCTAATTAA -> TGCTAATTAAC
TTGCTCTGCAC -> TGCTCTGCACA
TTGCTTTTTCT -> TGCTTTTTCTT
TTGGAATAGTG -> TGGAATAGTGA
TTGGACACAAC -> TGGACACAACG
TTGGACAGTAA -> TGGACAGTAAC
TTGGACTGTCG -> TGGACTGTCGC
TTGGATACATC -> TGGATACATCT
TTGGCAGAAGA -> TGGCAGAAGAC
TTGGCCGCTGG -> TGGCCGCTGGT
TTGGGCAGGAG -> TGGGCAGGAGA
TTGGGGCCTCC -> TGGGGCCTCCT
TTGGGGGCCAA -> TGGGGGCCAAA
TTGGGTATTCT -> TGGGTATTCTC
TTGTAACGGAC -> TGTAACGGACA
TTGTAGGAACA -> TGTAGGAACAC
TTGTAGGGTAA -> TGTAGGGTAAG
TTGTATCGTAC -> TGTATCGTACT
TTGTCGATGAC -> TGTCGATGACA
TTGTGGTGGAC -> TGTGGTGGACA
TTGTTAGTTAA -> TGTTAGTTAAT
TTGTTTAAACT -> TGTTTAAACTT
TTGTTTACACC -> TGTTTACACCG
TTGTTTTCACA -> TGTTTTCACAT
TTTAAACGAAC -> TTAAACGAACA
TTTAAACTTTA -> TTAAACTTTAG
TTTACAACACC -> TTACAACACCG
TTTACACCGGG -> TTACACCGGGG
TTTAGCATCCG -> TTAGCATCCGA
TTTAGGACTAA -> TTAGGACTAAT
TTTATAAATCC -> TTATAAATCCC
TTTATTCTTAG -> TTATTCTTAGT
TTTCAATCTTG -> TTCAATCTTGG
TTTCACATTCC -> TTCACATTCCT
TTTCACATTGG -> TTCACATTGGG
TTTCACATTTT -> TTCACATTTTG
TTTCACTTTGT -> TTCACTTTGTA
TTTCATAGCCG -> TTCATAGCCGT
TTTCTAAGAAC -> TTCTAAGAACA
TTTCTCATTGC -> TTCTCATTGCT
TTTCTTCTGGC -> TTCTTCTGGCT
TTTGAACACAA -> TTGAACACAAA
TTTGACACGCA -> TTGACACGCAC
TTTGATGACCG -> TTGATGACCGG
TTTGGGCAGGA -> TTGGGCAGGAG
TTTGGGGGCCA -> TTGGGGGCCAA
TTTGTATCGTA -> TTGTATCGTAC
TTTGTCGATGA -> TTGTCGATGAC
TTTTCAATCTT -> TTTCAATCTTG
TTTTCACATTT -> TTTCACATTTT
TTTTCTTCTGG -> TTTCTTCTGGC
TTTTGAACACA -> TTTGAACACAA
TTTTGACACGC -> TTTGACACGCA
TTTTGGGCAGG -> TTTGGGCAGGA
TTTTGGGGGCC -> TTTGGGGGCCA
TTTTTCTTCTG -> TTTTCTTCTGG
TTTTTGGGCAG -> TTTTGGGCAGG
TTTTTTGGGCA -> TTTTTGGGCAG
