AAAAAATTAGT -> AAAAATTAGTA
AAAAACCCAAA -> AAAACCCAAAC
AAAAACCGGTG -> AAAACCGGTGG
AAAAATTAGTA -> AAAATTAGTAC
AAAACCCAAAC -> AAACCCAAACT
AAAACCGGAGT -> AAACCGGAGTC
AAAACCGGTGG -> AAACCGGTGGG
AAAAGCTATGA -> AAAGCTATGAT
AAAAGGTGGTT -> AAAGGTGGTTT
AAAATAACCGA -> AAATAACCGAC
AAAATTAGTAC -> AAATTAGTACG
AAACAAACGAA -> AACAAACGAAT
AAACAACCCGC -> AACAACCCGCT
AAACCCAAACT -> AACCCAAACTT
AAACCCTGCAT -> AACCCTGCATT
AAACCGGAGTC -> AACCGGAGTCA
AAACCGGTGGG -> AACCGGTGGGT
AAACGAATTTC -> AACGAATTTCG
AAACGAGACCT -> AACGAGACCTA
AAACTTTTAGC -> AACTTTTAGCG
AAAGAGGGACA -> AAGAGGGACAT
AAAGCCAGTTA -> AAGCCAGTTAT
AAAGCGTCGGA -> AAGCGTCGGAG
AAAGCTAGTGC -> AAGCTAGTGCT
AAAGCTATGAT -> AAGCTATGATC
AAAGGTGATAG -> AAGGTGATAGG
AAAGGTGGTTT -> AAGGTGGTTTG
AAAGTAACCCC -> AAGTAACCCCT
AAAGTCGCTGC -> AAGTCGCTGCG
AAATAACCGAC -> AATAACCGACA
AAATCGGAAAG -> AATCGGAAAGC
AAATGACGCTG -> AATGACGCTGA
AAATTAAACGA -> AATTAAACGAG
AAATTAATTAA -> AATTAATTAAG
AAATTACTAAC -> AATTACTAACC
AAATTAGTACG -> AATTAGTACGT
AACAAACGAAT -> ACAAACGAATT
AACAAAGCGTC -> ACAAAGCGTCG
AACAACCCGCT -> ACAACCCGCTA
AACAGACAATA -> ACAGACAATAG
AACAGTCAGTA -> ACAGTCAGTAT
AACATCAAGGG -> ACATCAAGGGT
AACCATGTTGT -> ACCATGTTGTG
AACCCAAACTT -> ACCCAAACTTT
AACCCCTTTGC -> ACCCCTTTGCG
AACCCGCTACT -> ACCCGCTACTT
AACCCTGCATT -> ACCCTGCATTA
AACCGACATGT -> ACCGACATGTA
AACCGATTGCG -> ACCGATTGCGG
AACCGGAGTCA -> ACCGGAGTCAA
AACCGGTGGGT -> ACCGGTGGGTC
AACCTTAAAAG -> ACCTTAAAAGG
AACGAAGCATT -> ACGAAGCATTT
AACGAAGTAGC -> ACGAAGTAGCA
AACGAATTTCG -> ACGAATTTCGT
AACGAGACCTA -> ACGAGACCTAT
AACGAGTAGAA -> ACGAGTAGAAA
AACGGTAGGAC -> ACGGTAGGACG
AACGTGTCACG -> ACGTGTCACGG
AACTACCATGC -> ACTACCATGCT
AACTACTAGCC -> ACTACTAGCCC
AACTCTGTCGT -> ACTCTGTCGTC
AACTTCCGGGT -> ACTTCCGGGTA
AACTTCTAAGA -> ACTTCTAAGAG
AACTTTTAGCG -> ACTTTTAGCGG
AAGAAAACCGG -> AGAAAACCGGA
AAGAATTCGGA -> AGAATTCGGAA
AAGAGCAATTA -> AGAGCAATTAT
AAGAGCCCAAT -> AGAGCCCAATT
AAGAGGCAACA -> AGAGGCAACAG
AAGAGGGACAT -> AGAGGGACATG
AAGCACGAACT -> AGCACGAACTA
AAGCATTTGTT -> AGCATTTGTTT
AAGCCAGTTAT -> AGCCAGTTATA
AAGCCCCGCCT -> AGCCCCGCCTA
AAGCCCTGTTG -> AGCCCTGTTGG
AAGCGCGGACA -> AGCGCGGACAC
AAGCGGTAGCA -> AGCGGTAGCAG
AAGCGTCGGAG -> AGCGTCGGAGC
AAGCTAGTGCT -> AGCTAGTGCTG
AAGCTATGATC -> AGCTATGATCC
AAGCTTCGACC -> AGCTTCGACCC
AAGGAGCGACA -> AGGAGCGACAC
AAGGCTTACGA -> AGGCTTACGAA
AAGGGACGCTA -> AGGGACGCTAA
AAGGGTGTCGC -> AGGGTGTCGCT
AAGGTGATAGG -> AGGTGATAGGT
AAGGTGCAACT -> AGGTGCAACTC
AAGGTGGTTTG -> AGGTGGTTTGT
AAGTAACCCCT -> AGTAACCCCTT
AAGTAGCAAGG -> AGTAGCAAGGT
AAGTCCTAGTT -> AGTCCTAGTTG
AAGTCGCTGCG -> AGTCGCTGCGA
AAGTGCTGGGC -> AGTGCTGGGCG
AAGTTACTACT -> AGTTACTACTT
AAGTTGATAAT -> AGTTGATAATC
AATAACCGACA -> ATAACCGACAT
AATAAGAGCCC -> ATAAGAGCCCA
AATACCCGCGA -> ATACCCGCGAA
AATACGTCTGG -> ATACGTCTGGG
AATAGCAGCCG -> ATAGCAGCCGG
AATCCCCTGCG -> ATCCCCTGCGG
AATCGGAAAGC -> ATCGGAAAGCT
AATGACGCTGA -> ATGACGCTGAT
AATGCCGGCTA -> ATGCCGGCTAG
AATGGCTTGGG -> ATGGCTTGGGG
AATGTGACTAG -> ATGTGACTAGT
AATGTTCCCAA -> ATGTTCCCAAC
AATTAAACGAG -> ATTAAACGAGA
AATTAAGCGGT -> ATTAAGCGGTA
AATTAATTAAG -> ATTAATTAAGC
AATTACTAACC -> ATTACTAACCA
AATTACTGCTC -> ATTACTGCTCA
AATTAGCGACG -> ATTAGCGACGT
AATTAGTACGT -> ATTAGTACGTA
AATTATTTACC -> ATTATTTACCG
AATTCCACTAT -> ATTCCACTATC
AATTCGGAAGG -> ATTCGGAAGGA
AATTGCTGGCT -> ATTGCTGGCTG
AATTGGTTGTA -> ATTGGTTGTAA
AATTGTAGGTG -> ATTGTAGGTGT
AATTTCGTAGC -> ATTTCGTAGCG
AATTTGTGCAA -> ATTTGTGCAAG
ACAAAAGCTAT -> CAAAAGCTATG
ACAAACGAATT -> CAAACGAATTT
ACAAAGCGTCG -> CAAAGCGTCGG
ACAACCCGCTA -> CAACCCGCTAC
ACAACGTGTCA -> CAACGTGTCAC
ACAAGCGCGGA -> CAAGCGCGGAC
ACAATACGTCT -> CAATACGTCTG
ACAATAGCAGC -> CAATAGCAGCC
ACAATTAGCGA -> CAATTAGCGAC
ACACATTTGCC -> CACATTTGCCA
ACACCGGAAAG -> CACCGGAAAGG
ACACGACTGGG -> CACGACTGGGA
ACACTCAGCGC -> CACTCAGCGCG
ACACTCGGAGA -> CACTCGGAGAC
ACAGACAATAG -> CAGACAATAGC
ACAGCGAGCTT -> CAGCGAGCTTG
ACAGTCAGTAT -> CAGTCAGTATT
ACATCAAGGGT -> CATCAAGGGTG
ACATGTAATAC -> CATGTAATACC
ACATGTAGGAG -> CATGTAGGAGG
ACATGTCATAG -> CATGTCATAGA
ACATTGTGTAT -> CATTGTGTATG
ACATTTGCCAG -> CATTTGCCAGT
ACCAAATCGGA -> CCAAATCGGAA
ACCAGAAATTA -> CCAGAAATTAA
ACCATGCTCGC -> CCATGCTCGCC
ACCATGTTGTG -> CCATGTTGTGA
ACCCAAACTTT -> CCCAAACTTTT
ACCCACAACGT -> CCCACAACGTG
ACCCACGCAGG -> CCCACGCAGGA
ACCCCGGGAGC -> CCCCGGGAGCA
ACCCCTTTGCG -> CCCCTTTGCGA
ACCCGCGAATT -> CCCGCGAATTT
ACCCGCTACTT -> CCCGCTACTTG
ACCCTAATTGC -> CCCTAATTGCT
ACCCTGCATTA -> CCCTGCATTAG
ACCGACATGTA -> CCGACATGTAG
ACCGATTGCGG -> CCGATTGCGGT
ACCGCTAGCAC -> CCGCTAGCACA
ACCGGAAAGGT -> CCGGAAAGGTG
ACCGGAGTCAA -> CCGGAGTCAAA
ACCGGCGCACT -> CCGGCGCACTC
ACCGGTGGGTC -> CCGGTGGGTCG
ACCTATGGAGC -> CCTATGGAGCT
ACCTCGGATAT -> CCTCGGATATA
ACCTTAAAAGG -> CCTTAAAAGGT
ACCTTGCAGCA -> CCTTGCAGCAT
ACGAAACAAAC -> CGAAACAAACG
ACGAACAAAGC -> CGAACAAAGCG
ACGAACTACCA -> CGAACTACCAT
ACGAAGCATTT -> CGAAGCATTTG
ACGAAGTAGCA -> CGAAGTAGCAA
ACGAATTTCGT -> CGAATTTCGTA
ACGACCCACGC -> CGACCCACGCA
ACGACTGGGAC -> CGACTGGGACT
ACGAGACCTAT -> CGAGACCTATG
ACGAGTAGAAA -> CGAGTAGAAAG
ACGCAGGAGCG -> CGCAGGAGCGA
ACGCCAAGGGA -> CGCCAAGGGAC
ACGCCGCACGT -> CGCCGCACGTT
ACGCGCCCGCG -> CGCGCCCGCGT
ACGCTAAAGTA -> CGCTAAAGTAA
ACGCTCTAAAT -> CGCTCTAAATT
ACGCTGATTAC -> CGCTGATTACA
ACGCTGGTGTT -> CGCTGGTGTTG
ACGCTTATTAG -> CGCTTATTAGC
ACGCTTCGACT -> CGCTTCGACTT
ACGGGGCGTCG -> CGGGGCGTCGT
ACGGTAGGACG -> CGGTAGGACGC
ACGGTATGTAT -> CGGTATGTATA
ACGTATAGCCT -> CGTATAGCCTA
ACGTCTGGGTT -> CGTCTGGGTTA
ACGTGCTCTAA -> CGTGCTCTAAT
ACGTGTCACGG -> CGTGTCACGGG
ACGTTACCCCG -> CGTTACCCCGG
ACTAAACCCTG -> CTAAACCCTGC
ACTAAAGTCGC -> CTAAAGTCGCT
ACTAACCATGT -> CTAACCATGTT
ACTACCATGCT -> CTACCATGCTC
ACTACGCTTCG -> CTACGCTTCGA
ACTACTAGCCC -> CTACTAGCCCA
ACTACTTGGCC -> CTACTTGGCCG
ACTAGCCCACT -> CTAGCCCACTA
ACTATCTGTAA -> CTATCTGTAAG
ACTATCTGTAG -> CTATCTGTAGC
ACTCAGCGCGC -> CTCAGCGCGCA
ACTCGAAACAA -> CTCGAAACAAC
ACTCGATTACG -> CTCGATTACGA
ACTCGGAGACC -> CTCGGAGACCT
ACTCGTGATCC -> CTCGTGATCCG
ACTCTGATGCA -> CTCTGATGCAG
ACTCTGTCGTC -> CTCTGTCGTCT
ACTGAAGAAAA -> CTGAAGAAAAC
ACTGACGCTTA -> CTGACGCTTAT
ACTGAGTAATT -> CTGAGTAATTC
ACTGCTCACTT -> CTGCTCACTTA
ACTGGGACTCG -> CTGGGACTCGT
ACTGGTGTGTC -> CTGGTGTGTCT
ACTGTCAGTCT -> CTGTCAGTCTG
ACTGTCATAAC -> CTGTCATAACC
ACTTATTATCA -> CTTATTATCAG
ACTTCCGCGGA -> CTTCCGCGGAT
ACTTCCGGGTA -> CTTCCGGGTAT
ACTTCTAAGAG -> CTTCTAAGAGG
ACTTCTACACC -> CTTCTACACCG
ACTTCTTGACA -> CTTCTTGACAT
ACTTGAAGCCC -> CTTGAAGCCCC
ACTTGGCCGGC -> CTTGGCCGGCA
ACTTTGACTGA -> CTTTGACTGAG
ACTTTTAGCGG -> CTTTTAGCGGT
ACTTTTCCGGC -> CTTTTCCGGCC
AGAAAACCGGA -> GAAAACCGGAG
AGAAAGCCAGT -> GAAAGCCAGTT
AGAAATTAAAC -> GAAATTAAACG
AGAATGTTCCC -> GAATGTTCCCA
AGAATTCGGAA -> GAATTCGGAAG
AGACAATAGCA -> GACAATAGCAG
AGACCTATGGA -> GACCTATGGAG
AGACCTCGGAT -> GACCTCGGATA
AGACTAAACCC -> GACTAAACCCT
AGACTTTGACT -> GACTTTGACTG
AGAGCAATTAT -> GAGCAATTATT
AGAGCCCAATT -> GAGCCCAATTG
AGAGGCAACAG -> GAGGCAACAGA
AGAGGCGGGGA -> GAGGCGGGGAT
AGAGGGACATG -> GAGGGACATGT
AGAGTTTAACG -> GAGTTTAACGG
AGATTCGATCT -> GATTCGATCTC
AGCAAGGCTTA -> GCAAGGCTTAC
AGCAAGGTGCA -> GCAAGGTGCAA
AGCAATTATTT -> GCAATTATTTA
AGCACAGCGAG -> GCACAGCGAGC
AGCACGAACTA -> GCACGAACTAC
AGCAGACTAAA -> GCAGACTAAAC
AGCAGCCGGGG -> GCAGCCGGGGG
AGCAGGTCCTC -> GCAGGTCCTCC
AGCAGTGAACG -> GCAGTGAACGA
AGCATCAAAGA -> GCATCAAAGAG
AGCATTTCTTC -> GCATTTCTTCT
AGCATTTGTTT -> GCATTTGTTTG
AGCCAATAAGA -> GCCAATAAGAG
AGCCAGTTATA -> GCCAGTTATAA
AGCCCAATTGT -> GCCCAATTGTA
AGCCCACTATC -> GCCCACTATCT
AGCCCCGCCTA -> GCCCCGCCTAA
AGCCCGAGGTA -> GCCCGAGGTAG
AGCCCTGTTGG -> GCCCTGTTGGA
AGCCGGACGCT -> GCCGGACGCTG
AGCCGGGGGCA -> GCCGGGGGCAT
AGCCTAGTCTA -> GCCTAGTCTAC
AGCGACACATT -> GCGACACATTT
AGCGACGTGCT -> GCGACGTGCTC
AGCGACTGTCA -> GCGACTGTCAG
AGCGAGCTTGA -> GCGAGCTTGAG
AGCGCCGGGTT -> GCGCCGGGTTC
AGCGCGCAGTT -> GCGCGCAGTTT
AGCGCGGACAC -> GCGCGGACACT
AGCGGACAATA -> GCGGACAATAC
AGCGGTAGCAG -> GCGGTAGCAGA
AGCGGTCTTGT -> GCGGTCTTGTA
AGCGTCGGAGC -> GCGTCGGAGCC
AGCGTGAGTTG -> GCGTGAGTTGC
AGCTAGTGCTG -> GCTAGTGCTGA
AGCTATCGCTG -> GCTATCGCTGC
AGCTATGATCC -> GCTATGATCCA
AGCTCGACTGA -> GCTCGACTGAC
AGCTGTACAAA -> GCTGTACAAAA
AGCTTCGACCC -> GCTTCGACCCA
AGCTTGAGGCA -> GCTTGAGGCAT
AGGACGCTCTA -> GGACGCTCTAA
AGGAGCGACAC -> GGAGCGACACA
AGGAGCGACTG -> GGAGCGACTGT
AGGAGGTCGTG -> GGAGGTCGTGG
AGGATATCTAA -> GGATATCTAAT
AGGCAACAGAC -> GGCAACAGACA
AGGCACCAAAT -> GGCACCAAATC
AGGCATCGGCA -> GGCATCGGCAG
AGGCGGGGATC -> GGCGGGGATCT
AGGCTTACGAA -> GGCTTACGAAA
AGGGACATGTC -> GGGACATGTCA
AGGGACGCTAA -> GGGACGCTAAA
AGGGGATACTT -> GGGGATACTTT
AGGGGGTCAGC -> GGGGGTCAGCA
AGGGTGTCGCT -> GGGTGTCGCTT
AGGTAGGATAT -> GGTAGGATATC
AGGTCCTCCGG -> GGTCCTCCGGA
AGGTCGTGGGG -> GGTCGTGGGGC
AGGTCTTGGCT -> GGTCTTGGCTG
AGGTGATAGGT -> GGTGATAGGTC
AGGTGCAACTC -> GGTGCAACTCT
AGGTGGTTTGT -> GGTGGTTTGTT
AGGTGTACGAA -> GGTGTACGAAC
AGGTTTGTGGC -> GGTTTGTGGCA
AGTAACCCCTT -> GTAACCCCTTT
AGTAATTCCAC -> GTAATTCCACT
AGTACACGACT -> GTACACGACTG
AGTACGTATAG -> GTACGTATAGC
AGTAGAAAGCC -> GTAGAAAGCCA
AGTAGCAAGGT -> GTAGCAAGGTG
AGTAGTCATCC -> GTAGTCATCCC
AGTATTACTGT -> GTATTACTGTC
AGTCAAAAAAT -> GTCAAAAAATT
AGTCAGTATTA -> GTCAGTATTAC
AGTCATCCCCG -> GTCATCCCCGA
AGTCCTAGTTG -> GTCCTAGTTGG
AGTCGCTGCGA -> GTCGCTGCGAG
AGTCGTTGGGC -> GTCGTTGGGCT
AGTCTACACTC -> GTCTACACTCA
AGTCTCTTCCT -> GTCTCTTCCTC
AGTCTGAGTAG -> GTCTGAGTAGT
AGTGAACGAGT -> GTGAACGAGTA
AGTGCAAAATA -> GTGCAAAATAA
AGTGCACTCGA -> GTGCACTCGAT
AGTGCTGATCT -> GTGCTGATCTT
AGTGCTGGGCG -> GTGCTGGGCGA
AGTTACCCTAA -> GTTACCCTAAT
AGTTACTACTT -> GTTACTACTTG
AGTTATAAGAA -> GTTATAAGAAT
AGTTGATAATC -> GTTGATAATCC
AGTTGCGGCCA -> GTTGCGGCCAA
AGTTGGTCCCC -> GTTGGTCCCCG
AGTTTAACGGT -> GTTTAACGGTA
AGTTTGAACAG -> GTTTGAACAGT
AGTTTGCCTGC -> GTTTGCCTGCG
ATAAAAACCCA -> TAAAAACCCAA
ATAACCGACAT -> TAACCGACATG
ATAACCGATTG -> TAACCGATTGC
ATAAGAATTCG -> TAAGAATTCGG
ATAAGAGCCCA -> TAAGAGCCCAA
ATAAGCCCTGT -> TAAGCCCTGTT
ATAATCCCCTG -> TAATCCCCTGC
ATACCAGAAAT -> TACCAGAAATT
ATACCCGCGAA -> TACCCGCGAAT
ATACGTCTGGG -> TACGTCTGGGT
ATACTTTTCCG -> TACTTTTCCGG
ATAGATTCGAT -> TAGATTCGATC
ATAGCAGCCGG -> TAGCAGCCGGG
ATAGCCTAGTC -> TAGCCTAGTCT
ATAGGTCTTGG -> TAGGTCTTGGC
ATAGTGCACTC -> TAGTGCACTCG
ATATATCCGAG -> TATATCCGAGA
ATATCATAGTG -> TATCATAGTGC
ATATCCGAGAC -> TATCCGAGACT
ATATCTAATTA -> TATCTAATTAC
ATATGCACTGG -> TATGCACTGGT
ATCAAAGAGGG -> TCAAAGAGGGA
ATCAACGAAGT -> TCAACGAAGTA
ATCAAGGGTGT -> TCAAGGGTGTC
ATCAGCTGTAC -> TCAGCTGTACA
ATCATAGTGCA -> TCATAGTGCAC
ATCCAGCTATC -> TCCAGCTATCG
ATCCCCGATGT -> TCCCCGATGTG
ATCCCCTGCGG -> TCCCCTGCGGG
ATCCGAACTAC -> TCCGAACTACT
ATCCGAAGTTG -> TCCGAAGTTGA
ATCCGAGACTT -> TCCGAGACTTT
ATCCTCCGCCA -> TCCTCCGCCAC
ATCGCTATTCC -> TCGCTATTCCA
ATCGCTGCAGT -> TCGCTGCAGTC
ATCGGAAAGCT -> TCGGAAAGCTA
ATCGGCAGAGT -> TCGGCAGAGTT
ATCTAATTACT -> TCTAATTACTG
ATCTCACTAAA -> TCTCACTAAAG
ATCTGTAAGCA -> TCTGTAAGCAC
ATCTGTAGCCA -> TCTGTAGCCAA
ATCTTGGCCGG -> TCTTGGCCGGC
ATCTTTAGTTT -> TCTTTAGTTTG
ATGACGCTGAT -> TGACGCTGATT
ATGAGGTTTGT -> TGAGGTTTGTG
ATGATCCAGCT -> TGATCCAGCTA
ATGCACTGGTG -> TGCACTGGTGT
ATGCAGGGGGT -> TGCAGGGGGTC
ATGCCGGCTAG -> TGCCGGCTAGA
ATGCTCGCCGT -> TGCTCGCCGTG
ATGGAGCTCGA -> TGGAGCTCGAC
ATGGAGTACAC -> TGGAGTACACG
ATGGCTTGGGG -> TGGCTTGGGGT
ATGTAATACCC -> TGTAATACCCG
ATGTAGGAGGT -> TGTAGGAGGTC
ATGTATAAGCC -> TGTATAAGCCC
ATGTCATAGAT -> TGTCATAGATT
ATGTGACTAGT -> TGTGACTAGTT
ATGTGATAAAA -> TGTGATAAAAA
ATGTTCCCAAC -> TGTTCCCAACA
ATGTTGTGACT -> TGTTGTGACTT
ATTAAACGAGA -> TTAAACGAGAC
ATTAAGCGGTA -> TTAAGCGGTAG
ATTAATTAAGC -> TTAATTAAGCG
ATTACAATTAG -> TTACAATTAGC
ATTACGACCCA -> TTACGACCCAC
ATTACTAACCA -> TTACTAACCAT
ATTACTGAAGA -> TTACTGAAGAA
ATTACTGCTCA -> TTACTGCTCAC
ATTACTGTCAT -> TTACTGTCATA
ATTAGCGACGT -> TTAGCGACGTG
ATTAGCGTGAG -> TTAGCGTGAGT
ATTAGGCACCA -> TTAGGCACCAA
ATTAGTACGTA -> TTAGTACGTAT
ATTATCAGCTG -> TTATCAGCTGT
ATTATTGAACC -> TTATTGAACCT
ATTATTTACCG -> TTATTTACCGC
ATTATTTCCCT -> TTATTTCCCTC
ATTCCACTATC -> TTCCACTATCT
ATTCCACTCTG -> TTCCACTCTGA
ATTCGATCTCA -> TTCGATCTCAC
ATTCGCACGCC -> TTCGCACGCCG
ATTCGGAAGGA -> TTCGGAAGGAG
ATTGAACCTTA -> TTGAACCTTAA
ATTGCGGTCGG -> TTGCGGTCGGT
ATTGCTGGCTG -> TTGCTGGCTGG
ATTGGACAAGC -> TTGGACAAGCG
ATTGGTTGTAA -> TTGGTTGTAAG
ATTGTAGGTGT -> TTGTAGGTGTA
ATTGTGTATGG -> TTGTGTATGGA
ATTTACCGCTA -> TTTACCGCTAG
ATTTATCGCTA -> TTTATCGCTAT
ATTTCCCTCTG -> TTTCCCTCTGC
ATTTCGCACGG -> TTTCGCACGGT
ATTTCGTAGCG -> TTTCGTAGCGG
ATTTCTTCTCT -> TTTCTTCTCTA
ATTTGCCAGTT -> TTTGCCAGTTA
ATTTGTGCAAG -> TTTGTGCAAGA
ATTTGTTTGCC -> TTTGTTTGCCG
CAAAAAATTAG -> AAAAAATTAGT
CAAAAGCTATG -> AAAAGCTATGA
CAAAATAACCG -> AAAATAACCGA
CAAACGAATTT -> AAACGAATTTC
CAAACTTTTAG -> AAACTTTTAGC
CAAAGAGGGAC -> AAAGAGGGACA
CAAAGCGTCGG -> AAAGCGTCGGA
CAAATCGGAAA -> AAATCGGAAAG
CAAATGACGCT -> AAATGACGCTG
CAACAGACAAT -> AACAGACAATA
CAACATCAAGG -> AACATCAAGGG
CAACCCGCTAC -> AACCCGCTACT
CAACGAAGTAG -> AACGAAGTAGC
CAACGTGTCAC -> AACGTGTCACG
CAACTCTGTCG -> AACTCTGTCGT
CAACTTCCGGG -> AACTTCCGGGT
CAAGAGCAATT -> AAGAGCAATTA
CAAGCGCGGAC -> AAGCGCGGACA
CAAGGCTTACG -> AAGGCTTACGA
CAAGGGACGCT -> AAGGGACGCTA
CAAGGGTGTCG -> AAGGGTGTCGC
CAAGGTGCAAC -> AAGGTGCAACT
CAATAAGAGCC -> AATAAGAGCCC
CAATACGTCTG -> AATACGTCTGG
CAATAGCAGCC -> AATAGCAGCCG
CAATGGCTTGG -> AATGGCTTGGG
CAATGTGACTA -> AATGTGACTAG
CAATTAGCGAC -> AATTAGCGACG
CAATTATTTAC -> AATTATTTACC
CAATTGTAGGT -> AATTGTAGGTG
CACAACGTGTC -> ACAACGTGTCA
CACAGCGAGCT -> ACAGCGAGCTT
CACATTTGCCA -> ACATTTGCCAG
CACCAAATCGG -> ACCAAATCGGA
CACCGGAAAGG -> ACCGGAAAGGT
CACCGGCGCAC -> ACCGGCGCACT
CACCTTGCAGC -> ACCTTGCAGCA
CACGAACTACC -> ACGAACTACCA
CACGACTGGGA -> ACGACTGGGAC
CACGCAGGAGC -> ACGCAGGAGCG
CACGCCAAGGG -> ACGCCAAGGGA
CACGCCGCACG -> ACGCCGCACGT
CACGGGGCGTC -> ACGGGGCGTCG
CACGGTATGTA -> ACGGTATGTAT
CACGTTACCCC -> ACGTTACCCCG
CACTAAAGTCG -> ACTAAAGTCGC
CACTATCTGTA -> ACTATCTGTAA,ACTATCTGTAG
CACTCAGCGCG -> ACTCAGCGCGC
CACTCGAAACA -> ACTCGAAACAA
CACTCGATTAC -> ACTCGATTACG
CACTCGGAGAC -> ACTCGGAGACC
CACTCTGATGC -> ACTCTGATGCA
CACTGGTGTGT -> ACTGGTGTGTC
CACTTATTATC -> ACTTATTATCA
CAGAAATTAAA -> AGAAATTAAAC
CAGACAATAGC -> AGACAATAGCA
CAGACTAAACC -> AGACTAAACCC
CAGAGTTTAAC -> AGAGTTTAACG
CAGCAGTGAAC -> AGCAGTGAACG
CAGCATTTCTT -> AGCATTTCTTC
CAGCCGGGGGC -> AGCCGGGGGCA
CAGCGAGCTTG -> AGCGAGCTTGA
CAGCGCGCAGT -> AGCGCGCAGTT
CAGCTATCGCT -> AGCTATCGCTG
CAGCTGTACAA -> AGCTGTACAAA
CAGGAGCGACT -> AGGAGCGACTG
CAGGGGATACT -> AGGGGATACTT
CAGGGGGTCAG -> AGGGGGTCAGC
CAGGTCCTCCG -> AGGTCCTCCGG
CAGTATTACTG -> AGTATTACTGT
CAGTCAGTATT -> AGTCAGTATTA
CAGTCGTTGGG -> AGTCGTTGGGC
CAGTCTGAGTA -> AGTCTGAGTAG
CAGTGAACGAG -> AGTGAACGAGT
CAGTTACCCTA -> AGTTACCCTAA
CAGTTATAAGA -> AGTTATAAGAA
CAGTTTGCCTG -> AGTTTGCCTGC
CATAACCGATT -> ATAACCGATTG
CATAGATTCGA -> ATAGATTCGAT
CATAGTGCACT -> ATAGTGCACTC
CATCAAAGAGG -> ATCAAAGAGGG
CATCAAGGGTG -> ATCAAGGGTGT
CATCCCCGATG -> ATCCCCGATGT
CATCCTCCGCC -> ATCCTCCGCCA
CATCGGCAGAG -> ATCGGCAGAGT
CATGCTCGCCG -> ATGCTCGCCGT
CATGTAATACC -> ATGTAATACCC
CATGTAGGAGG -> ATGTAGGAGGT
CATGTCATAGA -> ATGTCATAGAT
CATGTTGTGAC -> ATGTTGTGACT
CATTAGGCACC -> ATTAGGCACCA
CATTCGCACGC -> ATTCGCACGCC
CATTGTGTATG -> ATTGTGTATGG
CATTTATCGCT -> ATTTATCGCTA
CATTTCTTCTC -> ATTTCTTCTCT
CATTTGCCAGT -> ATTTGCCAGTT
CATTTGTTTGC -> ATTTGTTTGCC
CCAAACTTTTA -> CAAACTTTTAG
CCAAATCGGAA -> CAAATCGGAAA
CCAACATCAAG -> CAACATCAAGG
CCAAGGGACGC -> CAAGGGACGCT
CCAATAAGAGC -> CAATAAGAGCC
CCAATGGCTTG -> CAATGGCTTGG
CCAATGTGACT -> CAATGTGACTA
CCAATTGTAGG -> CAATTGTAGGT
CCACAACGTGT -> CACAACGTGTC
CCACCGGCGCA -> CACCGGCGCAC
CCACGCAGGAG -> CACGCAGGAGC
CCACTATCTGT -> CACTATCTGTA
CCACTCTGATG -> CACTCTGATGC
CCAGAAATTAA -> CAGAAATTAAA
CCAGCTATCGC -> CAGCTATCGCT
CCAGTTACCCT -> CAGTTACCCTA
CCAGTTATAAG -> CAGTTATAAGA
CCATGCTCGCC -> CATGCTCGCCG
CCATGTTGTGA -> CATGTTGTGAC
CCCAAACTTTT -> CCAAACTTTTA
CCCAACATCAA -> CCAACATCAAG
CCCAATGTGAC -> CCAATGTGACT
CCCAATTGTAG -> CCAATTGTAGG
CCCACAACGTG -> CCACAACGTGT
CCCACGCAGGA -> CCACGCAGGAG
CCCACTATCTG -> CCACTATCTGT
CCCCGAGCGCC -> CCCGAGCGCCG
CCCCGATGTGA -> CCCGATGTGAT
CCCCGCCTAAC -> CCCGCCTAACT
CCCCGGGAGCA -> CCCGGGAGCAA
CCCCTGCGGGG -> CCCTGCGGGGC
CCCCTTTGCGA -> CCCTTTGCGAT
CCCGAGCGCCG -> CCGAGCGCCGG
CCCGAGGTAGG -> CCGAGGTAGGA
CCCGATGTGAT -> CCGATGTGATA
CCCGCCTAACT -> CCGCCTAACTT
CCCGCGAATTT -> CCGCGAATTTG
CCCGCGTCGTC -> CCGCGTCGTCT
CCCGCTACTTG -> CCGCTACTTGA
CCCGGGAGCAA -> CCGGGAGCAAG
CCCTAATTGCT -> CCTAATTGCTG
CCCTCTGCATT -> CCTCTGCATTC
CCCTGAAGTGC -> CCTGAAGTGCT
CCCTGCATTAG -> CCTGCATTAGG
CCCTGCGGGGC -> CCTGCGGGGCT
CCCTGTTGGAT -> CCTGTTGGATA
CCCTTTGCGAT -> CCTTTGCGATC
CCGAACTACTA -> CGAACTACTAG
CCGAAGTTGAT -> CGAAGTTGATA
CCGACATGTAG -> CGACATGTAGG
CCGAGACTTTG -> CGAGACTTTGA
CCGAGCGCCGG -> CGAGCGCCGGG
CCGAGGTAGGA -> CGAGGTAGGAT
CCGAGTCTCTT -> CGAGTCTCTTC
CCGATGAGGTT -> CGATGAGGTTT
CCGATGTGATA -> CGATGTGATAA
CCGATTGCGGT -> CGATTGCGGTC
CCGCACGTTAC -> CGCACGTTACC
CCGCCACCGGC -> CGCCACCGGCG
CCGCCTAACTT -> CGCCTAACTTC
CCGCGAATTTG -> CGCGAATTTGT
CCGCGGATATG -> CGCGGATATGC
CCGCGTCGTCT -> CGCGTCGTCTA
CCGCTACTTGA -> CGCTACTTGAA
CCGCTAGCACA -> CGCTAGCACAG
CCGGAAAGGTG -> CGGAAAGGTGA
CCGGAAGTCCT -> CGGAAGTCCTA
CCGGACGCTGG -> CGGACGCTGGT
CCGGAGTCAAA -> CGGAGTCAAAA
CCGGCAAATGA -> CGGCAAATGAC
CCGGCAACTTC -> CGGCAACTTCC
CCGGCCGGCAA -> CGGCCGGCAAA
CCGGCCGGGAA -> CGGCCGGGAAG
CCGGCGCACTC -> CGGCGCACTCG
CCGGCTAGAAT -> CGGCTAGAATG
CCGGGAAGCTT -> CGGGAAGCTTC
CCGGGAGCAAG -> CGGGAGCAAGG
CCGGGGGCATT -> CGGGGGCATTT
CCGGGTATTAT -> CGGGTATTATT
CCGGGTTCTCC -> CGGGTTCTCCC
CCGGTGGGTCG -> CGGTGGGTCGC
CCGTGAGCATC -> CGTGAGCATCA
CCTAACTTCTA -> CTAACTTCTAA
CCTAATTGCTG -> CTAATTGCTGG
CCTAGTCTACA -> CTAGTCTACAC
CCTAGTTGGTC -> CTAGTTGGTCC
CCTATGGAGCT -> CTATGGAGCTC
CCTCATCCTCC -> CTCATCCTCCG
CCTCCGCCACC -> CTCCGCCACCG
CCTCCGGAAGT -> CTCCGGAAGTC
CCTCGGATATA -> CTCGGATATAT
CCTCTGCATTC -> CTCTGCATTCG
CCTGAAGTGCT -> CTGAAGTGCTG
CCTGCATTAGG -> CTGCATTAGGC
CCTGCGCGTTG -> CTGCGCGTTGT
CCTGCGGGGCT -> CTGCGGGGCTT
CCTGGCTATAC -> CTGGCTATACC
CCTGTTGGATA -> CTGTTGGATAT
CCTTAAAAGGT -> CTTAAAAGGTG
CCTTATTTCGC -> CTTATTTCGCA
CCTTGCAGCAT -> CTTGCAGCATT
CCTTTGCGATC -> CTTTGCGATCC
CGAAACAAACG -> GAAACAAACGA
CGAAACAACCC -> GAAACAACCCG
CGAACAAAGCG -> GAACAAAGCGT
CGAACTACCAT -> GAACTACCATG
CGAACTACTAG -> GAACTACTAGC
CGAAGCATTTG -> GAAGCATTTGT
CGAAGTAGCAA -> GAAGTAGCAAG
CGAAGTTGATA -> GAAGTTGATAA
CGAATTTCGTA -> GAATTTCGTAG
CGAATTTGTGC -> GAATTTGTGCA
CGACACATTTG -> GACACATTTGC
CGACATGTAGG -> GACATGTAGGA
CGACCCACAAC -> GACCCACAACG
CGACCCACGCA -> GACCCACGCAG
CGACGTGCTCT -> GACGTGCTCTA
CGACTGACGCT -> GACTGACGCTT
CGACTGGGACT -> GACTGGGACTC
CGACTGTCAGT -> GACTGTCAGTC
CGACTTCCGCG -> GACTTCCGCGG
CGACTTCTTGA -> GACTTCTTGAC
CGAGACCTATG -> GAGACCTATGG
CGAGACTTTGA -> GAGACTTTGAC
CGAGCAGGTCC -> GAGCAGGTCCT
CGAGCGCCGGG -> GAGCGCCGGGT
CGAGCTTGAGG -> GAGCTTGAGGC
CGAGGTAGGAT -> GAGGTAGGATA
CGAGTAGAAAG -> GAGTAGAAAGC
CGAGTCTCTTC -> GAGTCTCTTCC
CGATCCGAAGT -> GATCCGAAGTT
CGATCTCACTA -> GATCTCACTAA
CGATGAGGTTT -> GATGAGGTTTG
CGATGTGATAA -> GATGTGATAAA
CGATTACGACC -> GATTACGACCC
CGATTATTGAA -> GATTATTGAAC
CGATTGCGGTC -> GATTGCGGTCG
CGCACCTTGCA -> GCACCTTGCAG
CGCACGCCGCA -> GCACGCCGCAC
CGCACGGTATG -> GCACGGTATGT
CGCACGTTACC -> GCACGTTACCC
CGCACTCGAAA -> GCACTCGAAAC
CGCAGGAGCGA -> GCAGGAGCGAC
CGCAGTTTGCC -> GCAGTTTGCCT
CGCCAAGGGAC -> GCCAAGGGACG
CGCCACCGGCG -> GCCACCGGCGC
CGCCCGCGTCG -> GCCCGCGTCGT
CGCCGCACGTT -> GCCGCACGTTA
CGCCGGGTTCT -> GCCGGGTTCTC
CGCCGTGAGCA -> GCCGTGAGCAT
CGCCTAACTTC -> GCCTAACTTCT
CGCGAATTTGT -> GCGAATTTGTG
CGCGCAGTTTG -> GCGCAGTTTGC
CGCGCCCGCGT -> GCGCCCGCGTC
CGCGGACACTC -> GCGGACACTCG
CGCGGATATGC -> GCGGATATGCA
CGCGTCGTCTA -> GCGTCGTCTAA
CGCGTTGTTAA -> GCGTTGTTAAA
CGCTAAAGTAA -> GCTAAAGTAAC
CGCTACTTGAA -> GCTACTTGAAG
CGCTAGCACAG -> GCTAGCACAGC
CGCTATTCCAC -> GCTATTCCACT
CGCTCTAAATT -> GCTCTAAATTA
CGCTGATTACA -> GCTGATTACAA
CGCTGCAGTCG -> GCTGCAGTCGT
CGCTGCGAGCA -> GCTGCGAGCAG
CGCTGGTGTTG -> GCTGGTGTTGT
CGCTTATTAGC -> GCTTATTAGCG
CGCTTCCTTAT -> GCTTCCTTATT
CGCTTCGACTT -> GCTTCGACTTC
CGGAAAGCTAG -> GGAAAGCTAGT
CGGAAAGGTGA -> GGAAAGGTGAT
CGGAAGGAGCG -> GGAAGGAGCGA
CGGAAGTCCTA -> GGAAGTCCTAG
CGGACAATACG -> GGACAATACGT
CGGACACTCGG -> GGACACTCGGA
CGGACGCTGGT -> GGACGCTGGTG
CGGAGACCTCG -> GGAGACCTCGG
CGGAGCCGGAC -> GGAGCCGGACG
CGGAGTCAAAA -> GGAGTCAAAAA
CGGATATATCC -> GGATATATCCG
CGGATATGCAC -> GGATATGCACT
CGGCAAATGAC -> GGCAAATGACG
CGGCAACTTCC -> GGCAACTTCCG
CGGCAGAGTTT -> GGCAGAGTTTA
CGGCCAATGGC -> GGCCAATGGCT
CGGCCGGCAAA -> GGCCGGCAAAT
CGGCCGGGAAG -> GGCCGGGAAGC
CGGCCTGGCTA -> GGCCTGGCTAT
CGGCGCACTCG -> GGCGCACTCGA
CGGCTAGAATG -> GGCTAGAATGT
CGGGAAGCTTC -> GGGAAGCTTCG
CGGGAGCAAGG -> GGGAGCAAGGC
CGGGGATCTTT -> GGGGATCTTTA
CGGGGCGTCGT -> GGGGCGTCGTT
CGGGGCTTAGT -> GGGGCTTAGTG
CGGGGGCATTT -> GGGGGCATTTA
CGGGTATTATT -> GGGTATTATTT
CGGGTTCTCCC -> GGGTTCTCCCT
CGGTAGCAGAC -> GGTAGCAGACT
CGGTAGGACGC -> GGTAGGACGCT
CGGTATGTATA -> GGTATGTATAA
CGGTCGGTGAG -> GGTCGGTGAGC
CGGTCTTGTAG -> GGTCTTGTAGA
CGGTGAGCCCG -> GGTGAGCCCGA
CGGTGGGTCGC -> GGTGGGTCGCA
CGTAGCGGACA -> GTAGCGGACAA
CGTATAGCCTA -> GTATAGCCTAG
CGTCGATTATT -> GTCGATTATTG
CGTCGGAGCCG -> GTCGGAGCCGG
CGTCGTCTAAC -> GTCGTCTAACG
CGTCGTTAATT -> GTCGTTAATTG
CGTCTAACGAA -> GTCTAACGAAG
CGTCTCTATTG -> GTCTCTATTGG
CGTCTGGGTTA -> GTCTGGGTTAC
CGTGAGCATCA -> GTGAGCATCAA
CGTGAGTTGCG -> GTGAGTTGCGG
CGTGATCCGAA -> GTGATCCGAAC
CGTGCTCTAAT -> GTGCTCTAATG
CGTGGGGCGGC -> GTGGGGCGGCC
CGTGTCACGGG -> GTGTCACGGGG
CGTTAATTGGT -> GTTAATTGGTT
CGTTACCCCGG -> GTTACCCCGGG
CGTTGGGCTGG -> GTTGGGCTGGT
CGTTGGTCCGA -> GTTGGTCCGAT
CGTTGTTAAAA -> GTTGTTAAAAA
CTAAACCCTGC -> TAAACCCTGCA
CTAAAGTAACC -> TAAAGTAACCC
CTAAAGTCGCT -> TAAAGTCGCTG
CTAAATTACTA -> TAAATTACTAA
CTAACCATGTT -> TAACCATGTTG
CTAACGAAGCA -> TAACGAAGCAT
CTAACTTCTAA -> TAACTTCTAAG
CTAAGAGGCAA -> TAAGAGGCAAC
CTAATGCCGGC -> TAATGCCGGCT
CTAATTACTGC -> TAATTACTGCT
CTAATTGCTGG -> TAATTGCTGGC
CTACACCGGAA -> TACACCGGAAA
CTACACTCAGC -> TACACTCAGCG
CTACCATGCTC -> TACCATGCTCG
CTACGCTTCGA -> TACGCTTCGAC
CTACTAGCCCA -> TACTAGCCCAC
CTACTTGAAGC -> TACTTGAAGCC
CTACTTGGCCG -> TACTTGGCCGG
CTAGAATGTTC -> TAGAATGTTCC
CTAGCACAGCG -> TAGCACAGCGA
CTAGCCCACTA -> TAGCCCACTAT
CTAGTCTACAC -> TAGTCTACACT
CTAGTGCTGAT -> TAGTGCTGATC
CTAGTTGGTCC -> TAGTTGGTCCC
CTATACCAGAA -> TATACCAGAAA
CTATCAACGAA -> TATCAACGAAG
CTATCGCTGCA -> TATCGCTGCAG
CTATCTGTAAG -> TATCTGTAAGC
CTATCTGTAGC -> TATCTGTAGCC
CTATGATCCAG -> TATGATCCAGC
CTATGGAGCTC -> TATGGAGCTCG
CTATTCCACTC -> TATTCCACTCT
CTATTGGACAA -> TATTGGACAAG
CTCACTAAAGT -> TCACTAAAGTC
CTCACTTATTA -> TCACTTATTAT
CTCAGCGCGCA -> TCAGCGCGCAG
CTCATCCTCCG -> TCATCCTCCGC
CTCCCTGAAGT -> TCCCTGAAGTG
CTCCGCCACCG -> TCCGCCACCGG
CTCCGGAAGTC -> TCCGGAAGTCC
CTCGAAACAAC -> TCGAAACAACC
CTCGACTGACG -> TCGACTGACGC
CTCGATTACGA -> TCGATTACGAC
CTCGCCGTGAG -> TCGCCGTGAGC
CTCGGAGACCT -> TCGGAGACCTC
CTCGGATATAT -> TCGGATATATC
CTCGTGATCCG -> TCGTGATCCGA
CTCGTTGGTCC -> TCGTTGGTCCG
CTCTAAATTAC -> TCTAAATTACT
CTCTAATGCCG -> TCTAATGCCGG
CTCTATCAACG -> TCTATCAACGA
CTCTATTGGAC -> TCTATTGGACA
CTCTGATGCAG -> TCTGATGCAGG
CTCTGCATTCG -> TCTGCATTCGC
CTCTGTCGTCT -> TCTGTCGTCTC
CTCTTCCTCAT -> TCTTCCTCATC
CTGAAGAAAAC -> TGAAGAAAACC
CTGAAGTGCTG -> TGAAGTGCTGG
CTGACGCTTAT -> TGACGCTTATT
CTGAGTAATTC -> TGAGTAATTCC
CTGAGTAGTCA -> TGAGTAGTCAT
CTGATCTTGGC -> TGATCTTGGCC
CTGATGCAGGG -> TGATGCAGGGG
CTGATTACAAT -> TGATTACAATT
CTGCAGTCGTT -> TGCAGTCGTTG
CTGCATTAGGC -> TGCATTAGGCA
CTGCATTCGCA -> TGCATTCGCAC
CTGCGAGCAGG -> TGCGAGCAGGT
CTGCGCGTTGT -> TGCGCGTTGTT
CTGCGGGGCTT -> TGCGGGGCTTA
CTGCGTCGATT -> TGCGTCGATTA
CTGCTCACTTA -> TGCTCACTTAT
CTGGCCCAATG -> TGGCCCAATGT
CTGGCTATACC -> TGGCTATACCA
CTGGCTGGCCC -> TGGCTGGCCCA
CTGGGACTCGT -> TGGGACTCGTG
CTGGGCGACTT -> TGGGCGACTTC
CTGGGTTACTA -> TGGGTTACTAC
CTGGTACATGT -> TGGTACATGTA
CTGGTGTGTCT -> TGGTGTGTCTC
CTGGTGTTGTA -> TGGTGTTGTAA
CTGTAAGCACG -> TGTAAGCACGA
CTGTACAAAAG -> TGTACAAAAGC
CTGTAGCCAAT -> TGTAGCCAATA
CTGTCAGTCTG -> TGTCAGTCTGA
CTGTCATAACC -> TGTCATAACCG
CTGTCGTCTCT -> TGTCGTCTCTA
CTGTTGGATAT -> TGTTGGATATC
CTTAAAAGGTG -> TTAAAAGGTGG
CTTACGAAACA -> TTACGAAACAA
CTTAGTGCAAA -> TTAGTGCAAAA
CTTATTAGCGT -> TTATTAGCGTG
CTTATTATCAG -> TTATTATCAGC
CTTATTTCGCA -> TTATTTCGCAC
CTTCCGCGGAT -> TTCCGCGGATA
CTTCCGGGTAT -> TTCCGGGTATT
CTTCCTCATCC -> TTCCTCATCCT
CTTCCTTATTT -> TTCCTTATTTC
CTTCGACCCAC -> TTCGACCCACA
CTTCGACTTCC -> TTCGACTTCCG
CTTCTAAGAGG -> TTCTAAGAGGC
CTTCTACACCG -> TTCTACACCGG
CTTCTCTATCA -> TTCTCTATCAA
CTTCTTGACAT -> TTCTTGACATT
CTTGAAGCCCC -> TTGAAGCCCCG
CTTGACATTGT -> TTGACATTGTG
CTTGAGGCATC -> TTGAGGCATCG
CTTGCAGCATT -> TTGCAGCATTT
CTTGGCCGGCA -> TTGGCCGGCAA
CTTGGCCGGCC -> TTGGCCGGCCG
CTTGGCTGCGT -> TTGGCTGCGTC
CTTGGGGTTAC -> TTGGGGTTACG
CTTGTAGAGGC -> TTGTAGAGGCG
CTTTAGTTTGA -> TTTAGTTTGAA
CTTTGACTGAG -> TTTGACTGAGT
CTTTGCGATCC -> TTTGCGATCCG
CTTTTAGCGGT -> TTTTAGCGGTC
CTTTTCCGGCC -> TTTTCCGGCCG
GAAAACCGGAG -> AAAACCGGAGT
GAAACAAACGA -> AAACAAACGAA
GAAACAACCCG -> AAACAACCCGC
GAAAGCCAGTT -> AAAGCCAGTTA
GAAAGCTAGTG -> AAAGCTAGTGC
GAAAGGTGATA -> AAAGGTGATAG
GAAATTAAACG -> AAATTAAACGA
GAACAAAGCGT -> AACAAAGCGTC
GAACAGTCAGT -> AACAGTCAGTA
GAACCTTAAAA -> AACCTTAAAAG
GAACGAGTAGA -> AACGAGTAGAA
GAACTACCATG -> AACTACCATGC
GAACTACTAGC -> AACTACTAGCC
GAAGAAAACCG -> AAGAAAACCGG
GAAGCATTTGT -> AAGCATTTGTT
GAAGCCCCGCC -> AAGCCCCGCCT
GAAGCTTCGAC -> AAGCTTCGACC
GAAGGAGCGAC -> AAGGAGCGACA
GAAGTAGCAAG -> AAGTAGCAAGG
GAAGTCCTAGT -> AAGTCCTAGTT
GAAGTGCTGGG -> AAGTGCTGGGC
GAAGTTGATAA -> AAGTTGATAAT
GAATGTTCCCA -> AATGTTCCCAA
GAATTCGGAAG -> AATTCGGAAGG
GAATTTCGTAG -> AATTTCGTAGC
GAATTTGTGCA -> AATTTGTGCAA
GACAAGCGCGG -> ACAAGCGCGGA
GACAATACGTC -> ACAATACGTCT
GACAATAGCAG -> ACAATAGCAGC
GACACATTTGC -> ACACATTTGCC
GACACTCGGAG -> ACACTCGGAGA
GACATGTAGGA -> ACATGTAGGAG
GACATGTCATA -> ACATGTCATAG
GACATTGTGTA -> ACATTGTGTAT
GACCCACAACG -> ACCCACAACGT
GACCCACGCAG -> ACCCACGCAGG
GACCTATGGAG -> ACCTATGGAGC
GACCTCGGATA -> ACCTCGGATAT
GACGCTAAAGT -> ACGCTAAAGTA
GACGCTCTAAA -> ACGCTCTAAAT
GACGCTGATTA -> ACGCTGATTAC
GACGCTGGTGT -> ACGCTGGTGTT
GACGCTTATTA -> ACGCTTATTAG
GACGTGCTCTA -> ACGTGCTCTAA
GACTAAACCCT -> ACTAAACCCTG
GACTCGTGATC -> ACTCGTGATCC
GACTGACGCTT -> ACTGACGCTTA
GACTGAGTAAT -> ACTGAGTAATT
GACTGGGACTC -> ACTGGGACTCG
GACTGTCAGTC -> ACTGTCAGTCT
GACTTCCGCGG -> ACTTCCGCGGA
GACTTCTACAC -> ACTTCTACACC
GACTTCTTGAC -> ACTTCTTGACA
GACTTTGACTG -> ACTTTGACTGA
GAGACCTATGG -> AGACCTATGGA
GAGACCTCGGA -> AGACCTCGGAT
GAGACTTTGAC -> AGACTTTGACT
GAGCAAGGCTT -> AGCAAGGCTTA
GAGCAATTATT -> AGCAATTATTT
GAGCAGGTCCT -> AGCAGGTCCTC
GAGCATCAAAG -> AGCATCAAAGA
GAGCCCAATTG -> AGCCCAATTGT
GAGCCCGAGGT -> AGCCCGAGGTA
GAGCCGGACGC -> AGCCGGACGCT
GAGCGACACAT -> AGCGACACATT
GAGCGACTGTC -> AGCGACTGTCA
GAGCGCCGGGT -> AGCGCCGGGTT
GAGCTCGACTG -> AGCTCGACTGA
GAGCTTGAGGC -> AGCTTGAGGCA
GAGGCAACAGA -> AGGCAACAGAC
GAGGCATCGGC -> AGGCATCGGCA
GAGGCGGGGAT -> AGGCGGGGATC
GAGGGACATGT -> AGGGACATGTC
GAGGTAGGATA -> AGGTAGGATAT
GAGGTCGTGGG -> AGGTCGTGGGG
GAGGTTTGTGG -> AGGTTTGTGGC
GAGTAATTCCA -> AGTAATTCCAC
GAGTACACGAC -> AGTACACGACT
GAGTAGAAAGC -> AGTAGAAAGCC
GAGTAGTCATC -> AGTAGTCATCC
GAGTCAAAAAA -> AGTCAAAAAAT
GAGTCTCTTCC -> AGTCTCTTCCT
GAGTTGCGGCC -> AGTTGCGGCCA
GAGTTTAACGG -> AGTTTAACGGT
GATAAAAACCC -> ATAAAAACCCA
GATAATCCCCT -> ATAATCCCCTG
GATACTTTTCC -> ATACTTTTCCG
GATAGGTCTTG -> ATAGGTCTTGG
GATATATCCGA -> ATATATCCGAG
GATATCATAGT -> ATATCATAGTG
GATATCTAATT -> ATATCTAATTA
GATATGCACTG -> ATATGCACTGG
GATCCAGCTAT -> ATCCAGCTATC
GATCCGAACTA -> ATCCGAACTAC
GATCCGAAGTT -> ATCCGAAGTTG
GATCTCACTAA -> ATCTCACTAAA
GATCTTGGCCG -> ATCTTGGCCGG
GATCTTTAGTT -> ATCTTTAGTTT
GATGAGGTTTG -> ATGAGGTTTGT
GATGCAGGGGG -> ATGCAGGGGGT
GATGTGATAAA -> ATGTGATAAAA
GATTACAATTA -> ATTACAATTAG
GATTACGACCC -> ATTACGACCCA
GATTACTGAAG -> ATTACTGAAGA
GATTATTGAAC -> ATTATTGAACC
GATTCGATCTC -> ATTCGATCTCA
GATTGCGGTCG -> ATTGCGGTCGG
GCAAAATAACC -> CAAAATAACCG
GCAAATGACGC -> CAAATGACGCT
GCAACAGACAA -> CAACAGACAAT
GCAACTCTGTC -> CAACTCTGTCG
GCAACTTCCGG -> CAACTTCCGGG
GCAAGAGCAAT -> CAAGAGCAATT
GCAAGGCTTAC -> CAAGGCTTACG
GCAAGGTGCAA -> CAAGGTGCAAC
GCAATTATTTA -> CAATTATTTAC
GCACAGCGAGC -> CACAGCGAGCT
GCACCAAATCG -> CACCAAATCGG
GCACCTTGCAG -> CACCTTGCAGC
GCACGAACTAC -> CACGAACTACC
GCACGCCAAGG -> CACGCCAAGGG
GCACGCCGCAC -> CACGCCGCACG
GCACGGTATGT -> CACGGTATGTA
GCACGTTACCC -> CACGTTACCCC
GCACTCGAAAC -> CACTCGAAACA
GCACTCGATTA -> CACTCGATTAC
GCACTGGTGTG -> CACTGGTGTGT
GCAGACTAAAC -> CAGACTAAACC
GCAGAGTTTAA -> CAGAGTTTAAC
GCAGCATTTCT -> CAGCATTTCTT
GCAGCCGGGGG -> CAGCCGGGGGC
GCAGGAGCGAC -> CAGGAGCGACT
GCAGGGGGTCA -> CAGGGGGTCAG
GCAGGTCCTCC -> CAGGTCCTCCG
GCAGTCGTTGG -> CAGTCGTTGGG
GCAGTGAACGA -> CAGTGAACGAG
GCAGTTTGCCT -> CAGTTTGCCTG
GCATCAAAGAG -> CATCAAAGAGG
GCATCGGCAGA -> CATCGGCAGAG
GCATTAGGCAC -> CATTAGGCACC
GCATTCGCACG -> CATTCGCACGC
GCATTTATCGC -> CATTTATCGCT
GCATTTCTTCT -> CATTTCTTCTC
GCATTTGTTTG -> CATTTGTTTGC
GCCAAGGGACG -> CCAAGGGACGC
GCCAATAAGAG -> CCAATAAGAGC
GCCAATGGCTT -> CCAATGGCTTG
GCCACCGGCGC -> CCACCGGCGCA
GCCAGTTACCC -> CCAGTTACCCT
GCCAGTTATAA -> CCAGTTATAAG
GCCCAATGTGA -> CCCAATGTGAC
GCCCAATTGTA -> CCCAATTGTAG
GCCCACTATCT -> CCCACTATCTG
GCCCCGCCTAA -> CCCCGCCTAAC
GCCCGAGGTAG -> CCCGAGGTAGG
GCCCGCGTCGT -> CCCGCGTCGTC
GCCCTGTTGGA -> CCCTGTTGGAT
GCCGAGTCTCT -> CCGAGTCTCTT
GCCGCACGTTA -> CCGCACGTTAC
GCCGGACGCTG -> CCGGACGCTGG
GCCGGCAAATG -> CCGGCAAATGA
GCCGGCAACTT -> CCGGCAACTTC
GCCGGCCGGCA -> CCGGCCGGCAA
GCCGGCTAGAA -> CCGGCTAGAAT
GCCGGGAAGCT -> CCGGGAAGCTT
GCCGGGGGCAT -> CCGGGGGCATT
GCCGGGTTCTC -> CCGGGTTCTCC
GCCGTGAGCAT -> CCGTGAGCATC
GCCTAACTTCT -> CCTAACTTCTA
GCCTAGTCTAC -> CCTAGTCTACA
GCCTGCGCGTT -> CCTGCGCGTTG
GCCTGGCTATA -> CCTGGCTATAC
GCGAATTTGTG -> CGAATTTGTGC
GCGACACATTT -> CGACACATTTG
GCGACGTGCTC -> CGACGTGCTCT
GCGACTGTCAG -> CGACTGTCAGT
GCGACTTCTTG -> CGACTTCTTGA
GCGAGCAGGTC -> CGAGCAGGTCC
GCGAGCTTGAG -> CGAGCTTGAGG
GCGATCCGAAG -> CGATCCGAAGT
GCGCACTCGAA -> CGCACTCGAAA
GCGCAGTTTGC -> CGCAGTTTGCC
GCGCCCGCGTC -> CGCCCGCGTCG
GCGCCGGGTTC -> CGCCGGGTTCT
GCGCGCAGTTT -> CGCGCAGTTTG
GCGCGGACACT -> CGCGGACACTC
GCGCGTTGTTA -> CGCGTTGTTAA
GCGGACAATAC -> CGGACAATACG
GCGGACACTCG -> CGGACACTCGG
GCGGATATGCA -> CGGATATGCAC
GCGGCCAATGG -> CGGCCAATGGC
GCGGCCTGGCT -> CGGCCTGGCTA
GCGGGGATCTT -> CGGGGATCTTT
GCGGGGCTTAG -> CGGGGCTTAGT
GCGGTAGCAGA -> CGGTAGCAGAC
GCGGTCGGTGA -> CGGTCGGTGAG
GCGGTCTTGTA -> CGGTCTTGTAG
GCGTCGATTAT -> CGTCGATTATT
GCGTCGGAGCC -> CGTCGGAGCCG
GCGTCGTCTAA -> CGTCGTCTAAC
GCGTCGTTAAT -> CGTCGTTAATT
GCGTGAGTTGC -> CGTGAGTTGCG
GCGTTGTTAAA -> CGTTGTTAAAA
GCTAAAGTAAC -> CTAAAGTAACC
GCTACTTGAAG -> CTACTTGAAGC
GCTAGAATGTT -> CTAGAATGTTC
GCTAGCACAGC -> CTAGCACAGCG
GCTAGTGCTGA -> CTAGTGCTGAT
GCTATACCAGA -> CTATACCAGAA
GCTATCGCTGC -> CTATCGCTGCA
GCTATGATCCA -> CTATGATCCAG
GCTATTCCACT -> CTATTCCACTC
GCTCACTTATT -> CTCACTTATTA
GCTCGACTGAC -> CTCGACTGACG
GCTCGCCGTGA -> CTCGCCGTGAG
GCTCTAAATTA -> CTCTAAATTAC
GCTCTAATGCC -> CTCTAATGCCG
GCTGATCTTGG -> CTGATCTTGGC
GCTGATTACAA -> CTGATTACAAT
GCTGCAGTCGT -> CTGCAGTCGTT
GCTGCGAGCAG -> CTGCGAGCAGG
GCTGCGTCGAT -> CTGCGTCGATT
GCTGGCCCAAT -> CTGGCCCAATG
GCTGGCTGGCC -> CTGGCTGGCCC
GCTGGGCGACT -> CTGGGCGACTT
GCTGGTACATG -> CTGGTACATGT
GCTGGTGTTGT -> CTGGTGTTGTA
GCTGTACAAAA -> CTGTACAAAAG
GCTTACGAAAC -> CTTACGAAACA
GCTTAGTGCAA -> CTTAGTGCAAA
GCTTATTAGCG -> CTTATTAGCGT
GCTTCCTTATT -> CTTCCTTATTT
GCTTCGACCCA -> CTTCGACCCAC
GCTTCGACTTC -> CTTCGACTTCC
GCTTGAGGCAT -> CTTGAGGCATC
GCTTGGGGTTA -> CTTGGGGTTAC
GGAAAGCTAGT -> GAAAGCTAGTG
GGAAAGGTGAT -> GAAAGGTGATA
GGAAGCTTCGA -> GAAGCTTCGAC
GGAAGGAGCGA -> GAAGGAGCGAC
GGAAGTCCTAG -> GAAGTCCTAGT
GGACAAGCGCG -> GACAAGCGCGG
GGACAATACGT -> GACAATACGTC
GGACACTCGGA -> GACACTCGGAG
GGACATGTCAT -> GACATGTCATA
GGACGCTAAAG -> GACGCTAAAGT
GGACGCTCTAA -> GACGCTCTAAA
GGACGCTGGTG -> GACGCTGGTGT
GGACTCGTGAT -> GACTCGTGATC
GGAGACCTCGG -> GAGACCTCGGA
GGAGCAAGGCT -> GAGCAAGGCTT
GGAGCCGGACG -> GAGCCGGACGC
GGAGCGACACA -> GAGCGACACAT
GGAGCGACTGT -> GAGCGACTGTC
GGAGCTCGACT -> GAGCTCGACTG
GGAGGTCGTGG -> GAGGTCGTGGG
GGAGTACACGA -> GAGTACACGAC
GGAGTCAAAAA -> GAGTCAAAAAA
GGATACTTTTC -> GATACTTTTCC
GGATATATCCG -> GATATATCCGA
GGATATCATAG -> GATATCATAGT
GGATATCTAAT -> GATATCTAATT
GGATATGCACT -> GATATGCACTG
GGATCTTTAGT -> GATCTTTAGTT
GGCAAATGACG -> GCAAATGACGC
GGCAACAGACA -> GCAACAGACAA
GGCAACTTCCG -> GCAACTTCCGG
GGCACCAAATC -> GCACCAAATCG
GGCACGCCAAG -> GCACGCCAAGG
GGCAGAGTTTA -> GCAGAGTTTAA
GGCATCGGCAG -> GCATCGGCAGA
GGCATTTATCG -> GCATTTATCGC
GGCCAATGGCT -> GCCAATGGCTT
GGCCCAATGTG -> GCCCAATGTGA
GGCCGGCAAAT -> GCCGGCAAATG
GGCCGGCAACT -> GCCGGCAACTT
GGCCGGCCGGC -> GCCGGCCGGCA
GGCCGGGAAGC -> GCCGGGAAGCT
GGCCTGGCTAT -> GCCTGGCTATA
GGCGACTTCTT -> GCGACTTCTTG
GGCGCACTCGA -> GCGCACTCGAA
GGCGGCCTGGC -> GCGGCCTGGCT
GGCGGGGATCT -> GCGGGGATCTT
GGCGTCGTTAA -> GCGTCGTTAAT
GGCTAGAATGT -> GCTAGAATGTT
GGCTATACCAG -> GCTATACCAGA
GGCTGCGTCGA -> GCTGCGTCGAT
GGCTGGCCCAA -> GCTGGCCCAAT
GGCTGGTACAT -> GCTGGTACATG
GGCTTACGAAA -> GCTTACGAAAC
GGCTTAGTGCA -> GCTTAGTGCAA
GGCTTGGGGTT -> GCTTGGGGTTA
GGGAAGCTTCG -> GGAAGCTTCGA
GGGACATGTCA -> GGACATGTCAT
GGGACGCTAAA -> GGACGCTAAAG
GGGACTCGTGA -> GGACTCGTGAT
GGGAGCAAGGC -> GGAGCAAGGCT
GGGATACTTTT -> GGATACTTTTC
GGGATCTTTAG -> GGATCTTTAGT
GGGCATTTATC -> GGCATTTATCG
GGGCGACTTCT -> GGCGACTTCTT
GGGCGGCCTGG -> GGCGGCCTGGC
GGGCGTCGTTA -> GGCGTCGTTAA
GGGCTGGTACA -> GGCTGGTACAT
GGGCTTAGTGC -> GGCTTAGTGCA
GGGGATACTTT -> GGGATACTTTT
GGGGATCTTTA -> GGGATCTTTAG
GGGGCATTTAT -> GGGCATTTATC
GGGGCGGCCTG -> GGGCGGCCTGG
GGGGCGTCGTT -> GGGCGTCGTTA
GGGGCTTAGTG -> GGGCTTAGTGC
GGGGGCATTTA -> GGGGCATTTAT
GGGGGTCAGCA -> GGGGTCAGCAG
GGGGTCAGCAG -> GGGTCAGCAGT
GGGGTTACGCG -> GGGTTACGCGC
GGGTATTATTT -> GGTATTATTTC
GGGTCAGCAGT -> GGTCAGCAGTG
GGGTCGCACCT -> GGTCGCACCTT
GGGTGTCGCTT -> GGTGTCGCTTC
GGGTTACGCGC -> GGTTACGCGCC
GGGTTACTACG -> GGTTACTACGC
GGGTTCTCCCT -> GGTTCTCCCTG
GGTACATGTAA -> GTACATGTAAT
GGTAGCAGACT -> GTAGCAGACTA
GGTAGGACGCT -> GTAGGACGCTC
GGTAGGATATC -> GTAGGATATCT
GGTATGTATAA -> GTATGTATAAG
GGTATTATTTC -> GTATTATTTCC
GGTCAGCAGTG -> GTCAGCAGTGA
GGTCCCCGAGC -> GTCCCCGAGCG
GGTCCGATGAG -> GTCCGATGAGG
GGTCCTCCGGA -> GTCCTCCGGAA
GGTCGCACCTT -> GTCGCACCTTG
GGTCGGTGAGC -> GTCGGTGAGCC
GGTCGTGGGGC -> GTCGTGGGGCG
GGTCTTGGCTG -> GTCTTGGCTGC
GGTCTTGTAGA -> GTCTTGTAGAG
GGTGAGCCCGA -> GTGAGCCCGAG
GGTGATAGGTC -> GTGATAGGTCT
GGTGCAACTCT -> GTGCAACTCTG
GGTGGGTCGCA -> GTGGGTCGCAC
GGTGGTTTGTT -> GTGGTTTGTTC
GGTGTACGAAC -> GTGTACGAACA
GGTGTCGCTTC -> GTGTCGCTTCC
GGTGTGTCTCG -> GTGTGTCTCGT
GGTGTTGTAAA -> GTGTTGTAAAT
GGTTACGCGCC -> GTTACGCGCCC
GGTTACTACGC -> GTTACTACGCT
GGTTCTCCCTG -> GTTCTCCCTGA
GGTTGTAAGTT -> GTTGTAAGTTA
GGTTTGTGGCA -> GTTTGTGGCAC
GGTTTGTTCAG -> GTTTGTTCAGG
GTAAATTAATT -> TAAATTAATTA
GTAACCCCTTT -> TAACCCCTTTG
GTAAGCACGAA -> TAAGCACGAAC
GTAAGTTACTA -> TAAGTTACTAC
GTAATACCCGC -> TAATACCCGCG
GTAATTCCACT -> TAATTCCACTA
GTACAAAAGCT -> TACAAAAGCTA
GTACACGACTG -> TACACGACTGG
GTACATGTAAT -> TACATGTAATA
GTACGAACAAA -> TACGAACAAAG
GTACGTATAGC -> TACGTATAGCC
GTAGAAAGCCA -> TAGAAAGCCAG
GTAGAGGCGGG -> TAGAGGCGGGG
GTAGCAAGGTG -> TAGCAAGGTGC
GTAGCAGACTA -> TAGCAGACTAA
GTAGCCAATAA -> TAGCCAATAAG
GTAGCGGACAA -> TAGCGGACAAT
GTAGGACGCTC -> TAGGACGCTCT
GTAGGAGGTCG -> TAGGAGGTCGT
GTAGGATATCT -> TAGGATATCTA
GTAGGTGTACG -> TAGGTGTACGA
GTAGTCATCCC -> TAGTCATCCCC
GTATAAGCCCT -> TATAAGCCCTG
GTATAGCCTAG -> TATAGCCTAGT
GTATGGAGTAC -> TATGGAGTACA
GTATGTATAAG -> TATGTATAAGC
GTATTACTGTC -> TATTACTGTCA
GTATTATTTCC -> TATTATTTCCC
GTCAAAAAATT -> TCAAAAAATTA
GTCACGGGGCG -> TCACGGGGCGT
GTCAGCAGTGA -> TCAGCAGTGAA
GTCAGTATTAC -> TCAGTATTACT
GTCAGTCTGAG -> TCAGTCTGAGT
GTCATAACCGA -> TCATAACCGAT
GTCATAGATTC -> TCATAGATTCG
GTCATCCCCGA -> TCATCCCCGAT
GTCCCCGAGCG -> TCCCCGAGCGC
GTCCGATGAGG -> TCCGATGAGGT
GTCCTAGTTGG -> TCCTAGTTGGT
GTCCTCCGGAA -> TCCTCCGGAAG
GTCGATTATTG -> TCGATTATTGA
GTCGCACCTTG -> TCGCACCTTGC
GTCGCTGCGAG -> TCGCTGCGAGC
GTCGCTTCCTT -> TCGCTTCCTTA
GTCGGAGCCGG -> TCGGAGCCGGA
GTCGGTGAGCC -> TCGGTGAGCCC
GTCGTCTAACG -> TCGTCTAACGA
GTCGTCTCTAT -> TCGTCTCTATT
GTCGTGGGGCG -> TCGTGGGGCGG
GTCGTTAATTG -> TCGTTAATTGG
GTCGTTGGGCT -> TCGTTGGGCTG
GTCTAACGAAG -> TCTAACGAAGC
GTCTACACTCA -> TCTACACTCAG
GTCTCGTTGGT -> TCTCGTTGGTC
GTCTCTATTGG -> TCTCTATTGGA
GTCTCTTCCTC -> TCTCTTCCTCA
GTCTGAGTAGT -> TCTGAGTAGTC
GTCTGGGTTAC -> TCTGGGTTACT
GTCTTGGCTGC -> TCTTGGCTGCG
GTCTTGTAGAG -> TCTTGTAGAGG
GTGAACGAGTA -> TGAACGAGTAG
GTGACTAGTTT -> TGACTAGTTTC
GTGACTTCTAC -> TGACTTCTACA
GTGAGCATCAA -> TGAGCATCAAA
GTGAGCCCGAG -> TGAGCCCGAGG
GTGAGTTGCGG -> TGAGTTGCGGC
GTGATAAAAAC -> TGATAAAAACC
GTGATAGGTCT -> TGATAGGTCTT
GTGATCCGAAC -> TGATCCGAACT
GTGCAAAATAA -> TGCAAAATAAC
GTGCAACTCTG -> TGCAACTCTGT
GTGCAAGAGCA -> TGCAAGAGCAA
GTGCACTCGAT -> TGCACTCGATT
GTGCTCTAATG -> TGCTCTAATGC
GTGCTGATCTT -> TGCTGATCTTG
GTGCTGGGCGA -> TGCTGGGCGAC
GTGGCACGCCA -> TGGCACGCCAA
GTGGGGCGGCC -> TGGGGCGGCCT
GTGGGTCGCAC -> TGGGTCGCACC
GTGGTTTGTTC -> TGGTTTGTTCA
GTGTACGAACA -> TGTACGAACAA
GTGTATGGAGT -> TGTATGGAGTA
GTGTCACGGGG -> TGTCACGGGGC
GTGTCGCTTCC -> TGTCGCTTCCT
GTGTCTCGTTG -> TGTCTCGTTGG
GTGTGTCTCGT -> TGTGTCTCGTT
GTGTTGTAAAT -> TGTTGTAAATT
GTTAAAAACCG -> TTAAAAACCGG
GTTAATTGGTT -> TTAATTGGTTG
GTTACCCCGGG -> TTACCCCGGGA
GTTACCCTAAT -> TTACCCTAATT
GTTACGCGCCC -> TTACGCGCCCG
GTTACTACGCT -> TTACTACGCTT
GTTACTACTTG -> TTACTACTTGG
GTTATAAGAAT -> TTATAAGAATT
GTTCAGGGGAT -> TTCAGGGGATA
GTTCCCAACAT -> TTCCCAACATC
GTTCTCCCTGA -> TTCTCCCTGAA
GTTGATAATCC -> TTGATAATCCC
GTTGATTACTG -> TTGATTACTGA
GTTGCGGCCAA -> TTGCGGCCAAT
GTTGGATATCA -> TTGGATATCAT
GTTGGGCTGGT -> TTGGGCTGGTA
GTTGGTCCCCG -> TTGGTCCCCGA
GTTGGTCCGAT -> TTGGTCCGATG
GTTGTAAATTA -> TTGTAAATTAA
GTTGTAAGTTA -> TTGTAAGTTAC
GTTGTGACTTC -> TTGTGACTTCT
GTTGTTAAAAA -> TTGTTAAAAAC
GTTTAACGGTA -> TTTAACGGTAG
GTTTGAACAGT -> TTTGAACAGTC
GTTTGCCGAGT -> TTTGCCGAGTC
GTTTGCCTGCG -> TTTGCCTGCGC
GTTTGTGGCAC -> TTTGTGGCACG
GTTTGTTCAGG -> TTTGTTCAGGG
TAAAAACCCAA -> AAAAACCCAAA
TAAAAACCGGT -> AAAAACCGGTG
TAAAAGGTGGT -> AAAAGGTGGTT
TAAACCCTGCA -> AAACCCTGCAT
TAAACGAGACC -> AAACGAGACCT
TAAAGTAACCC -> AAAGTAACCCC
TAAAGTCGCTG -> AAAGTCGCTGC
TAAATTAATTA -> AAATTAATTAA
TAAATTACTAA -> AAATTACTAAC
TAACCATGTTG -> AACCATGTTGT
TAACCCCTTTG -> AACCCCTTTGC
TAACCGACATG -> AACCGACATGT
TAACCGATTGC -> AACCGATTGCG
TAACGAAGCAT -> AACGAAGCATT
TAACGGTAGGA -> AACGGTAGGAC
TAACTTCTAAG -> AACTTCTAAGA
TAAGAATTCGG -> AAGAATTCGGA
TAAGAGCCCAA -> AAGAGCCCAAT
TAAGAGGCAAC -> AAGAGGCAACA
TAAGCACGAAC -> AAGCACGAACT
TAAGCCCTGTT -> AAGCCCTGTTG
TAAGCGGTAGC -> AAGCGGTAGCA
TAAGTTACTAC -> AAGTTACTACT
TAATACCCGCG -> AATACCCGCGA
TAATCCCCTGC -> AATCCCCTGCG
TAATGCCGGCT -> AATGCCGGCTA
TAATTAAGCGG -> AATTAAGCGGT
TAATTACTGCT -> AATTACTGCTC
TAATTCCACTA -> AATTCCACTAT
TAATTGCTGGC -> AATTGCTGGCT
TAATTGGTTGT -> AATTGGTTGTA
TACAAAAGCTA -> ACAAAAGCTAT
TACAATTAGCG -> ACAATTAGCGA
TACACCGGAAA -> ACACCGGAAAG
TACACGACTGG -> ACACGACTGGG
TACACTCAGCG -> ACACTCAGCGC
TACATGTAATA -> ACATGTAATAC
TACCAGAAATT -> ACCAGAAATTA
TACCATGCTCG -> ACCATGCTCGC
TACCCCGGGAG -> ACCCCGGGAGC
TACCCGCGAAT -> ACCCGCGAATT
TACCCTAATTG -> ACCCTAATTGC
TACCGCTAGCA -> ACCGCTAGCAC
TACGAAACAAA -> ACGAAACAAAC
TACGAACAAAG -> ACGAACAAAGC
TACGACCCACG -> ACGACCCACGC
TACGCGCCCGC -> ACGCGCCCGCG
TACGCTTCGAC -> ACGCTTCGACT
TACGTATAGCC -> ACGTATAGCCT
TACGTCTGGGT -> ACGTCTGGGTT
TACTAACCATG -> ACTAACCATGT
TACTACGCTTC -> ACTACGCTTCG
TACTACTTGGC -> ACTACTTGGCC
TACTAGCCCAC -> ACTAGCCCACT
TACTGAAGAAA -> ACTGAAGAAAA
TACTGCTCACT -> ACTGCTCACTT
TACTGTCATAA -> ACTGTCATAAC
TACTTGAAGCC -> ACTTGAAGCCC
TACTTGGCCGG -> ACTTGGCCGGC
TACTTTTCCGG -> ACTTTTCCGGC
TAGAAAGCCAG -> AGAAAGCCAGT
TAGAATGTTCC -> AGAATGTTCCC
TAGAGGCGGGG -> AGAGGCGGGGA
TAGATTCGATC -> AGATTCGATCT
TAGCAAGGTGC -> AGCAAGGTGCA
TAGCACAGCGA -> AGCACAGCGAG
TAGCAGACTAA -> AGCAGACTAAA
TAGCAGCCGGG -> AGCAGCCGGGG
TAGCCAATAAG -> AGCCAATAAGA
TAGCCCACTAT -> AGCCCACTATC
TAGCCTAGTCT -> AGCCTAGTCTA
TAGCGACGTGC -> AGCGACGTGCT
TAGCGGACAAT -> AGCGGACAATA
TAGCGGTCTTG -> AGCGGTCTTGT
TAGCGTGAGTT -> AGCGTGAGTTG
TAGGACGCTCT -> AGGACGCTCTA
TAGGAGGTCGT -> AGGAGGTCGTG
TAGGATATCTA -> AGGATATCTAA
TAGGCACCAAA -> AGGCACCAAAT
TAGGTCTTGGC -> AGGTCTTGGCT
TAGGTGTACGA -> AGGTGTACGAA
TAGTACGTATA -> AGTACGTATAG
TAGTCATCCCC -> AGTCATCCCCG
TAGTCTACACT -> AGTCTACACTC
TAGTGCAAAAT -> AGTGCAAAATA
TAGTGCACTCG -> AGTGCACTCGA
TAGTGCTGATC -> AGTGCTGATCT
TAGTTGGTCCC -> AGTTGGTCCCC
TAGTTTGAACA -> AGTTTGAACAG
TATAAGAATTC -> ATAAGAATTCG
TATAAGCCCTG -> ATAAGCCCTGT
TATACCAGAAA -> ATACCAGAAAT
TATAGCCTAGT -> ATAGCCTAGTC
TATATCCGAGA -> ATATCCGAGAC
TATCAACGAAG -> ATCAACGAAGT
TATCAGCTGTA -> ATCAGCTGTAC
TATCATAGTGC -> ATCATAGTGCA
TATCCGAGACT -> ATCCGAGACTT
TATCGCTATTC -> ATCGCTATTCC
TATCGCTGCAG -> ATCGCTGCAGT
TATCTAATTAC -> ATCTAATTACT
TATCTGTAAGC -> ATCTGTAAGCA
TATCTGTAGCC -> ATCTGTAGCCA
TATGATCCAGC -> ATGATCCAGCT
TATGCACTGGT -> ATGCACTGGTG
TATGGAGCTCG -> ATGGAGCTCGA
TATGGAGTACA -> ATGGAGTACAC
TATGTATAAGC -> ATGTATAAGCC
TATTACTGTCA -> ATTACTGTCAT
TATTAGCGTGA -> ATTAGCGTGAG
TATTATCAGCT -> ATTATCAGCTG
TATTATTTCCC -> ATTATTTCCCT
TATTCCACTCT -> ATTCCACTCTG
TATTGAACCTT -> ATTGAACCTTA
TATTGGACAAG -> ATTGGACAAGC
TATTTACCGCT -> ATTTACCGCTA
TATTTCCCTCT -> ATTTCCCTCTG
TATTTCGCACG -> ATTTCGCACGG
TCAAAAAATTA -> CAAAAAATTAG
TCAAAGAGGGA -> CAAAGAGGGAC
TCAACGAAGTA -> CAACGAAGTAG
TCAAGGGTGTC -> CAAGGGTGTCG
TCACGGGGCGT -> CACGGGGCGTC
TCACTAAAGTC -> CACTAAAGTCG
TCACTTATTAT -> CACTTATTATC
TCAGCAGTGAA -> CAGCAGTGAAC
TCAGCGCGCAG -> CAGCGCGCAGT
TCAGCTGTACA -> CAGCTGTACAA
TCAGGGGATAC -> CAGGGGATACT
TCAGTATTACT -> CAGTATTACTG
TCAGTCTGAGT -> CAGTCTGAGTA
TCATAACCGAT -> CATAACCGATT
TCATAGATTCG -> CATAGATTCGA
TCATAGTGCAC -> CATAGTGCACT
TCATCCCCGAT -> CATCCCCGATG
TCATCCTCCGC -> CATCCTCCGCC
TCCACTATCTG -> CCACTATCTGT
TCCACTCTGAT -> CCACTCTGATG
TCCAGCTATCG -> CCAGCTATCGC
TCCCAACATCA -> CCCAACATCAA
TCCCCGAGCGC -> CCCCGAGCGCC
TCCCCGATGTG -> CCCCGATGTGA
TCCCCTGCGGG -> CCCCTGCGGGG
TCCCTCTGCAT -> CCCTCTGCATT
TCCCTGAAGTG -> CCCTGAAGTGC
TCCGAACTACT -> CCGAACTACTA
TCCGAAGTTGA -> CCGAAGTTGAT
TCCGAGACTTT -> CCGAGACTTTG
TCCGATGAGGT -> CCGATGAGGTT
TCCGCCACCGG -> CCGCCACCGGC
TCCGCGGATAT -> CCGCGGATATG
TCCGGAAGTCC -> CCGGAAGTCCT
TCCGGCCGGGA -> CCGGCCGGGAA
TCCGGGTATTA -> CCGGGTATTAT
TCCTAGTTGGT -> CCTAGTTGGTC
TCCTCATCCTC -> CCTCATCCTCC
TCCTCCGCCAC -> CCTCCGCCACC
TCCTCCGGAAG -> CCTCCGGAAGT
TCCTTATTTCG -> CCTTATTTCGC
TCGAAACAACC -> CGAAACAACCC
TCGACCCACAA -> CGACCCACAAC
TCGACTGACGC -> CGACTGACGCT
TCGACTTCCGC -> CGACTTCCGCG
TCGATCTCACT -> CGATCTCACTA
TCGATTACGAC -> CGATTACGACC
TCGATTATTGA -> CGATTATTGAA
TCGCACCTTGC -> CGCACCTTGCA
TCGCACGCCGC -> CGCACGCCGCA
TCGCACGGTAT -> CGCACGGTATG
TCGCCGTGAGC -> CGCCGTGAGCA
TCGCTATTCCA -> CGCTATTCCAC
TCGCTGCAGTC -> CGCTGCAGTCG
TCGCTGCGAGC -> CGCTGCGAGCA
TCGCTTCCTTA -> CGCTTCCTTAT
TCGGAAAGCTA -> CGGAAAGCTAG
TCGGAAGGAGC -> CGGAAGGAGCG
TCGGAGACCTC -> CGGAGACCTCG
TCGGAGCCGGA -> CGGAGCCGGAC
TCGGATATATC -> CGGATATATCC
TCGGCAGAGTT -> CGGCAGAGTTT
TCGGTGAGCCC -> CGGTGAGCCCG
TCGTAGCGGAC -> CGTAGCGGACA
TCGTCTAACGA -> CGTCTAACGAA
TCGTCTCTATT -> CGTCTCTATTG
TCGTGATCCGA -> CGTGATCCGAA
TCGTGGGGCGG -> CGTGGGGCGGC
TCGTTAATTGG -> CGTTAATTGGT
TCGTTGGGCTG -> CGTTGGGCTGG
TCGTTGGTCCG -> CGTTGGTCCGA
TCTAAATTACT -> CTAAATTACTA
TCTAACGAAGC -> CTAACGAAGCA
TCTAAGAGGCA -> CTAAGAGGCAA
TCTAATGCCGG -> CTAATGCCGGC
TCTAATTACTG -> CTAATTACTGC
TCTACACCGGA -> CTACACCGGAA
TCTACACTCAG -> CTACACTCAGC
TCTATCAACGA -> CTATCAACGAA
TCTATTGGACA -> CTATTGGACAA
TCTCACTAAAG -> CTCACTAAAGT
TCTCCCTGAAG -> CTCCCTGAAGT
TCTCGTTGGTC -> CTCGTTGGTCC
TCTCTATCAAC -> CTCTATCAACG
TCTCTATTGGA -> CTCTATTGGAC
TCTCTTCCTCA -> CTCTTCCTCAT
TCTGAGTAGTC -> CTGAGTAGTCA
TCTGATGCAGG -> CTGATGCAGGG
TCTGCATTCGC -> CTGCATTCGCA
TCTGGGTTACT -> CTGGGTTACTA
TCTGTAAGCAC -> CTGTAAGCACG
TCTGTAGCCAA -> CTGTAGCCAAT
TCTGTCGTCTC -> CTGTCGTCTCT
TCTTCCTCATC -> CTTCCTCATCC
TCTTCTCTATC -> CTTCTCTATCA
TCTTGACATTG -> CTTGACATTGT
TCTTGGCCGGC -> CTTGGCCGGCC
TCTTGGCTGCG -> CTTGGCTGCGT
TCTTGTAGAGG -> CTTGTAGAGGC
TCTTTAGTTTG -> CTTTAGTTTGA
TGAACAGTCAG -> GAACAGTCAGT
TGAACCTTAAA -> GAACCTTAAAA
TGAACGAGTAG -> GAACGAGTAGA
TGAAGAAAACC -> GAAGAAAACCG
TGAAGCCCCGC -> GAAGCCCCGCC
TGAAGTGCTGG -> GAAGTGCTGGG
TGACATTGTGT -> GACATTGTGTA
TGACGCTGATT -> GACGCTGATTA
TGACGCTTATT -> GACGCTTATTA
TGACTGAGTAA -> GACTGAGTAAT
TGACTTCTACA -> GACTTCTACAC
TGAGCATCAAA -> GAGCATCAAAG
TGAGCCCGAGG -> GAGCCCGAGGT
TGAGGCATCGG -> GAGGCATCGGC
TGAGGTTTGTG -> GAGGTTTGTGG
TGAGTAATTCC -> GAGTAATTCCA
TGAGTAGTCAT -> GAGTAGTCATC
TGAGTTGCGGC -> GAGTTGCGGCC
TGATAAAAACC -> GATAAAAACCC
TGATAATCCCC -> GATAATCCCCT
TGATAGGTCTT -> GATAGGTCTTG
TGATCCAGCTA -> GATCCAGCTAT
TGATCCGAACT -> GATCCGAACTA
TGATCTTGGCC -> GATCTTGGCCG
TGATGCAGGGG -> GATGCAGGGGG
TGATTACAATT -> GATTACAATTA
TGATTACTGAA -> GATTACTGAAG
TGCAAAATAAC -> GCAAAATAACC
TGCAACTCTGT -> GCAACTCTGTC
TGCAAGAGCAA -> GCAAGAGCAAT
TGCACTCGATT -> GCACTCGATTA
TGCACTGGTGT -> GCACTGGTGTG
TGCAGCATTTC -> GCAGCATTTCT
TGCAGGGGGTC -> GCAGGGGGTCA
TGCAGTCGTTG -> GCAGTCGTTGG
TGCATTAGGCA -> GCATTAGGCAC
TGCATTCGCAC -> GCATTCGCACG
TGCCAGTTACC -> GCCAGTTACCC
TGCCGAGTCTC -> GCCGAGTCTCT
TGCCGGCTAGA -> GCCGGCTAGAA
TGCCTGCGCGT -> GCCTGCGCGTT
TGCGAGCAGGT -> GCGAGCAGGTC
TGCGATCCGAA -> GCGATCCGAAG
TGCGCGTTGTT -> GCGCGTTGTTA
TGCGGCCAATG -> GCGGCCAATGG
TGCGGGGCTTA -> GCGGGGCTTAG
TGCGGTCGGTG -> GCGGTCGGTGA
TGCGTCGATTA -> GCGTCGATTAT
TGCTCACTTAT -> GCTCACTTATT
TGCTCGCCGTG -> GCTCGCCGTGA
TGCTCTAATGC -> GCTCTAATGCC
TGCTGATCTTG -> GCTGATCTTGG
TGCTGGCTGGC -> GCTGGCTGGCC
TGCTGGGCGAC -> GCTGGGCGACT
TGGACAAGCGC -> GGACAAGCGCG
TGGAGCTCGAC -> GGAGCTCGACT
TGGAGTACACG -> GGAGTACACGA
TGGATATCATA -> GGATATCATAG
TGGCACGCCAA -> GGCACGCCAAG
TGGCCCAATGT -> GGCCCAATGTG
TGGCCGGCAAC -> GGCCGGCAACT
TGGCCGGCCGG -> GGCCGGCCGGC
TGGCTATACCA -> GGCTATACCAG
TGGCTGCGTCG -> GGCTGCGTCGA
TGGCTGGCCCA -> GGCTGGCCCAA
TGGCTTGGGGT -> GGCTTGGGGTT
TGGGACTCGTG -> GGGACTCGTGA
TGGGCGACTTC -> GGGCGACTTCT
TGGGCTGGTAC -> GGGCTGGTACA
TGGGGCGGCCT -> GGGGCGGCCTG
TGGGGTTACGC -> GGGGTTACGCG
TGGGTCGCACC -> GGGTCGCACCT
TGGGTTACTAC -> GGGTTACTACG
TGGTACATGTA -> GGTACATGTAA
TGGTCCCCGAG -> GGTCCCCGAGC
TGGTCCGATGA -> GGTCCGATGAG
TGGTGTGTCTC -> GGTGTGTCTCG
TGGTGTTGTAA -> GGTGTTGTAAA
TGGTTGTAAGT -> GGTTGTAAGTT
TGGTTTGTTCA -> GGTTTGTTCAG
TGTAAATTAAT -> GTAAATTAATT
TGTAAGCACGA -> GTAAGCACGAA
TGTAAGTTACT -> GTAAGTTACTA
TGTAATACCCG -> GTAATACCCGC
TGTACAAAAGC -> GTACAAAAGCT
TGTACGAACAA -> GTACGAACAAA
TGTAGAGGCGG -> GTAGAGGCGGG
TGTAGCCAATA -> GTAGCCAATAA
TGTAGGAGGTC -> GTAGGAGGTCG
TGTAGGTGTAC -> GTAGGTGTACG
TGTATAAGCCC -> GTATAAGCCCT
TGTATGGAGTA -> GTATGGAGTAC
TGTCACGGGGC -> GTCACGGGGCG
TGTCAGTCTGA -> GTCAGTCTGAG
TGTCATAACCG -> GTCATAACCGA
TGTCATAGATT -> GTCATAGATTC
TGTCGCTTCCT -> GTCGCTTCCTT
TGTCGTCTCTA -> GTCGTCTCTAT
TGTCTCGTTGG -> GTCTCGTTGGT
TGTGACTAGTT -> GTGACTAGTTT
TGTGACTTCTA -> GTGACTTCTAC
TGTGATAAAAA -> GTGATAAAAAC
TGTGCAAGAGC -> GTGCAAGAGCA
TGTGGCACGCC -> GTGGCACGCCA
TGTGTATGGAG -> GTGTATGGAGT
TGTGTCTCGTT -> GTGTCTCGTTG
TGTTAAAAACC -> GTTAAAAACCG
TGTTCAGGGGA -> GTTCAGGGGAT
TGTTCCCAACA -> GTTCCCAACAT
TGTTGGATATC -> GTTGGATATCA
TGTTGTAAATT -> GTTGTAAATTA
TGTTGTGACTT -> GTTGTGACTTC
TGTTTGCCGAG -> GTTTGCCGAGT
TTAAAAACCGG -> TAAAAACCGGT
TTAAAAGGTGG -> TAAAAGGTGGT
TTAAACGAGAC -> TAAACGAGACC
TTAACGGTAGG -> TAACGGTAGGA
TTAAGCGGTAG -> TAAGCGGTAGC
TTAATTAAGCG -> TAATTAAGCGG
TTAATTGGTTG -> TAATTGGTTGT
TTACAATTAGC -> TACAATTAGCG
TTACCCCGGGA -> TACCCCGGGAG
TTACCCTAATT -> TACCCTAATTG
TTACCGCTAGC -> TACCGCTAGCA
TTACGAAACAA -> TACGAAACAAA
TTACGACCCAC -> TACGACCCACG
TTACGCGCCCG -> TACGCGCCCGC
TTACTAACCAT -> TACTAACCATG
TTACTACGCTT -> TACTACGCTTC
TTACTACTTGG -> TACTACTTGGC
TTACTGAAGAA -> TACTGAAGAAA
TTACTGCTCAC -> TACTGCTCACT
TTACTGTCATA -> TACTGTCATAA
TTAGCGACGTG -> TAGCGACGTGC
TTAGCGGTCTT -> TAGCGGTCTTG
TTAGCGTGAGT -> TAGCGTGAGTT
TTAGGCACCAA -> TAGGCACCAAA
TTAGTACGTAT -> TAGTACGTATA
TTAGTGCAAAA -> TAGTGCAAAAT
TTAGTTTGAAC -> TAGTTTGAACA
TTATAAGAATT -> TATAAGAATTC
TTATCAGCTGT -> TATCAGCTGTA
TTATCGCTATT -> TATCGCTATTC
TTATTAGCGTG -> TATTAGCGTGA
TTATTATCAGC -> TATTATCAGCT
TTATTGAACCT -> TATTGAACCTT
TTATTTACCGC -> TATTTACCGCT
TTATTTCCCTC -> TATTTCCCTCT
TTATTTCGCAC -> TATTTCGCACG
TTCAGGGGATA -> TCAGGGGATAC
TTCCACTATCT -> TCCACTATCTG
TTCCACTCTGA -> TCCACTCTGAT
TTCCCAACATC -> TCCCAACATCA
TTCCCTCTGCA -> TCCCTCTGCAT
TTCCGCGGATA -> TCCGCGGATAT
TTCCGGCCGGG -> TCCGGCCGGGA
TTCCGGGTATT -> TCCGGGTATTA
TTCCTCATCCT -> TCCTCATCCTC
TTCCTTATTTC -> TCCTTATTTCG
TTCGACCCACA -> TCGACCCACAA
TTCGACTTCCG -> TCGACTTCCGC
TTCGATCTCAC -> TCGATCTCACT
TTCGCACGCCG -> TCGCACGCCGC
TTCGCACGGTA -> TCGCACGGTAT
TTCGGAAGGAG -> TCGGAAGGAGC
TTCGTAGCGGA -> TCGTAGCGGAC
TTCTAAGAGGC -> TCTAAGAGGCA
TTCTACACCGG -> TCTACACCGGA
TTCTCCCTGAA -> TCTCCCTGAAG
TTCTCTATCAA -> TCTCTATCAAC
TTCTTCTCTAT -> TCTTCTCTATC
TTCTTGACATT -> TCTTGACATTG
TTGAACAGTCA -> TGAACAGTCAG
TTGAACCTTAA -> TGAACCTTAAA
TTGAAGCCCCG -> TGAAGCCCCGC
TTGACATTGTG -> TGACATTGTGT
TTGACTGAGTA -> TGACTGAGTAA
TTGAGGCATCG -> TGAGGCATCGG
TTGATAATCCC -> TGATAATCCCC
TTGATTACTGA -> TGATTACTGAA
TTGCAGCATTT -> TGCAGCATTTC
TTGCCAGTTAC -> TGCCAGTTACC
TTGCCGAGTCT -> TGCCGAGTCTC
TTGCCTGCGCG -> TGCCTGCGCGT
TTGCGATCCGA -> TGCGATCCGAA
TTGCGGCCAAT -> TGCGGCCAATG
TTGCGGTCGGT -> TGCGGTCGGTG
TTGCTGGCTGG -> TGCTGGCTGGC
TTGGACAAGCG -> TGGACAAGCGC
TTGGATATCAT -> TGGATATCATA
TTGGCCGGCAA -> TGGCCGGCAAC
TTGGCCGGCCG -> TGGCCGGCCGG
TTGGCTGCGTC -> TGGCTGCGTCG
TTGGGCTGGTA -> TGGGCTGGTAC
TTGGGGTTACG -> TGGGGTTACGC
TTGGTCCCCGA -> TGGTCCCCGAG
TTGGTCCGATG -> TGGTCCGATGA
TTGGTTGTAAG -> TGGTTGTAAGT
TTGTAAATTAA -> TGTAAATTAAT
TTGTAAGTTAC -> TGTAAGTTACT
TTGTAGAGGCG -> TGTAGAGGCGG
TTGTAGGTGTA -> TGTAGGTGTAC
TTGTGACTTCT -> TGTGACTTCTA
TTGTGCAAGAG -> TGTGCAAGAGC
TTGTGGCACGC -> TGTGGCACGCC
TTGTGTATGGA -> TGTGTATGGAG
TTGTTAAAAAC -> TGTTAAAAACC
TTGTTCAGGGG -> TGTTCAGGGGA
TTGTTTGCCGA -> TGTTTGCCGAG
TTTAACGGTAG -> TTAACGGTAGG
TTTACCGCTAG -> TTACCGCTAGC
TTTAGCGGTCT -> TTAGCGGTCTT
TTTAGTTTGAA -> TTAGTTTGAAC
TTTATCGCTAT -> TTATCGCTATT
TTTCCCTCTGC -> TTCCCTCTGCA
TTTCCGGCCGG -> TTCCGGCCGGG
TTTCGCACGGT -> TTCGCACGGTA
TTTCGTAGCGG -> TTCGTAGCGGA
TTTCTTCTCTA -> TTCTTCTCTAT
TTTGAACAGTC -> TTGAACAGTCA
TTTGACTGAGT -> TTGACTGAGTA
TTTGCCAGTTA -> TTGCCAGTTAC
TTTGCCGAGTC -> TTGCCGAGTCT
TTTGCCTGCGC -> TTGCCTGCGCG
TTTGCGATCCG -> TTGCGATCCGA
TTTGTGCAAGA -> TTGTGCAAGAG
TTTGTGGCACG -> TTGTGGCACGC
TTTGTTCAGGG -> TTGTTCAGGGG
TTTGTTTGCCG -> TTGTTTGCCGA
TTTTAGCGGTC -> TTTAGCGGTCT
TTTTCCGGCCG -> TTTCCGGCCGG
